AGAF => Afutara Афутара
AGAR => Arona Арона
AGAT => Atoifi Атоифи
AGAT => Uroubi 
AGBA => Barakoma Баракома
AGBT => Batuna 
AGEV => Geva Жева-Эйрстрип
AGGB => Bellona Беллона
AGGC => Choiseul Bay Чойсфул-Бей
AGGD => Mbambanakira Мбамбанакира
AGGE => Balalae Балале
AGGF => Fera Island Фера-Айленд
AGGH => Honiara 
AGGJ => Avu Avu Аву-Аву
AGGK => Kirakira Киракира
AGGL => Santa Cruz Is 
AGGM => Munda 
AGGN => Gizo Гизо
AGGO => Mono Моно
AGGP => Parasi Параси
AGGR => Rennell 
AGGS => Sege Сиж
AGGT => Santa Ana Санта-Ана
AGGU => Marau Sound 
AGGV => Suavanao Суаванао
AGGY => Yandina 
AGKG => Kagau 
AGKU => Kukundu Кукунди
AGRC => Ringi Cove Ринги-Коув
ANYN => Nauru Island 
AYBK => Buka 
AYCH => Kundiawa 
AYDU => Daru Дару
AYGA => Goroka Горока
AYGN => Alotau 
AYGR => Popondetta Попондетта
AYHK => Hoskins 
AYKA => Losuia Лосуя
AYKI => Kiunga Киунга
AYKK => Kikori Кикори
AYKM => Kerema Керема
AYKT => Kieta Киета
AYKV => Kavieng Кавьенг
AYKY => Lihir Island 
AYMD => Madang Маданг
AYMH => Mount Hagen 
AYMN => Mendi Менди
AYMO => Manus Island 
AYMR => Moro 
AYMS => Misima Island 
AYNZ => Lae 
AYPY => Port Moresby Порт-Морсби
AYTA => Tari Тари
AYTB => Tabubil Табубил
AYTK => Rabaul Рабаул
AYVN => Vanimo Ванимо
AYWD => Wapenamanda Вапенаманда
AYWK => Wewak Вевак
BGAA => Aasiaat 
BGAM => Tasiilaq 
BGAP => Alluitsup Paa 
BGAR => Arsuk Арсук
BGBW => Narsarsuaq 
BGCH => Qasigiannguit 
BGCO => Neerlerit Inaat 
BGDU => Dundas Дундас
BGFH => Paamiut 
BGGD => Groennedal 
BGGH => Nuuk 
BGGH => Nojeh 
BGGN => Qeqertarsuaq 
BGIG => Iginniarfik 
BGJH => Qaqortoq 
BGJN => Ilulissat 
BGKA => Kangaatsiaq 
BGKK => Kulusuk 
BGMQ => Maniitsoq 
BGNN => Nanortalik Нанорталик
BGNS => Narsaq 
BGQQ => Qaanaaq 
BGQQ => Niaqornaarsuk 
BGQQ => Murzuq 
BGSC => Ittoqqortoormiit 
BGSF => Kangerlussuaq 
BGSQ => Saqqaq 
BGSS => Sisimiut 
BGTL => Pituffik 
BGUK => Upernavik Упернавик
BGUM => Uummannaq Уумманнак
BGUQ => Qaarsut 
BIAR => Akureyri Акурейри
BIBD => Bildudalur Билдудалур
BIBF => Borgarfjordur Eystri 
BIBK => Bakkafjordur Баккафьордур
BIBL => Blonduos 
BIBV => Breiddalsvik 
BIDV => Djupivogur Джупивогур
BIEG => Egilsstadir Эгилсстадир
BIFF => Faskrudsfjordur Фаскрудсфьордур
BIFM => Fagurholsmyri Фагурхолсмыри
BIGF => Grundarfjordur 
BIGJ => Gjogur 
BIGR => Grimsey Гримси
BIHK => Holmavik Холмавик
BIHN => Hornafjordur 
BIHT => Flateyri 
BIHU => Husavik Хусавик
BIHV => Hvammstangi Хваммстанги
BIIS => Isafjordur Исафьордур
BIKF => Reykjavik Рейкьявик
BIKP => Kopasker Копаскер
BIKR => Saudarkrokur Саударкрокур
BINF => Nordfjordur Нордфьордур
BIOF => Olafsfjordur Олаффьордур
BIPA => Patreksfjordur Патрексфьордур
BIRE => Reykholar Рейкхолар
BIRG => Raufarhofn Рауфархофн
BIRK => Reykjavik Рейкьявик
BIRL => Myvatn Миватн
BISI => Siglufjordur Сиглуфьордур
BIST => Stykkisholmur Стиккишолмур
BITE => Thingeyri Тингейри
BITN => Thorshofn Торсхофн
BIVM => Vestmannaeyjar Вестменнейяр
BIVO => Vopnafjordur Вопнафьордур
BKPR => Prishtina 
CVFT => Lontras 
CWAR => Argentia 
CWBK => Mesalia 
CWCI => Caribou Island 
CWDM => Culver City 
CWJU => Langara 
CWMT => Boulder 
CWMT => Wha Ti/Lac La Martre 
CWNU => Slate Island 
CWPF => Esquimalt 
CWVO => Tamky Тамки
CYAB => Arctic Bay 
CYAC => Cat Lake 
CYAD => Moose Lake 
CYAG => Fort Frances 
CYAH => Lagrande 4 
CYAL => Alert Bay 
CYAM => Sault Ste Marie Со Сен Мари
CYAQ => Kasabonika 
CYAS => Kangirsuk 
CYAT => Attawapiskat 
CYAU => Kattiniq 
CYAW => Halifax Галифакс
CYAY => St Anthony 
CYAZ => Tofino, BC 
CYBA => Banff Банфф
CYBB => Kugaaruk 
CYBC => Baie Comeau 
CYBD => Bella Coola, BC 
CYBD => New Westminster 
CYBE => Uranium City 
CYBF => Bonnyville, AB 
CYBG => Bagotville 
CYBH => Bull Harbour 
CYBK => Baker Lake 
CYBL => Campbell River Кэмпбелл Ривер
CYBN => Borden 
CYBQ => Tadoule Lake 
CYBQ => Telegraph Harbour 
CYBR => Brandon Брэндон
CYBT => Brochet 
CYBV => Berens River 
CYBX => Blanc Sablon 
CYCA => Courtenay 
CYCA => Cartwright 
CYCB => Cambridge Bay 
CYCC => Cornwall 
CYCD => Nanaimo Нанаимо
CYCD => Nanaimo Нанаимо
CYCE => Centralia 
CYCG => Castlegar 
CYCH => Miramichi 
CYCJ => Cape St James 
CYCL => Charlo 
CYCN => Cochrane Кочране
CYCO => Kugluktuk/Coppermine 
CYCP => Co-op Point 
CYCQ => Chetwynd 
CYCR => Cross Lake 
CYCS => Chesterfield Inlet 
CYCT => Coronation 
CYCV => Cartierville 
CYCW => Chilliwack Чиллиуок
CYCX => Gagetown 
CYCY => Clyde River 
CYCZ => Fairmont Hot Springs 
CYDA => Dawson City 
CYDB => Burwash Landings 
CYDF => Deer Lake 
CYDK => Main Duck Island 
CYDL => Dease Lake 
CYDM => Ross River 
CYDN => Lathrop Wells 
CYDN => Dauphin 
CYDO => Dolbeau 
CYDP => Nain 
CYDQ => Dawson Creek 
CYDR => Broadview 
CYED => Edmonton Едмонтон
CYEG => Edmonton, AB 
CYEK => Arviat 
CYEL => Elliot Lake 
CYEM => Manitowaning 
CYEN => Estevan 
CYEP => Estevan Point 
CYER => Fort Severn 
CYET => Edson 
CYEU => Eureka 
CYEV => Inuvik 
CYEY => Amos 
CYFA => Fort Albany 
CYFB => Iqaluit 
CYFC => Fredericton Фредериктон
CYFE => Forestville 
CYFH => Fort Hope 
CYFJ => Snare Lake 
CYFL => Fort Reliance 
CYFO => Flin Flon 
CYFR => Fort Resolution 
CYFS => Fort Simpson 
CYFT => Makkovik 
CYGB => Gillies Bay 
CYGH => Fort Good Hope 
CYGK => Kingston Кингстоун
CYGL => La Grande 
CYGM => Gimli 
CYGO => Gods Narrows 
CYGQ => Geraldton 
CYGR => Iles De La Madeleine 
CYGS => Germansen 
CYGT => Igloolik 
CYGV => Havre St Pierre 
CYGW => Kuujjuarapik 
CYGX => Gillam 
CYGY => Deception 
CYGZ => Grise Fiord 
CYHA => Port Hope Simpson 
CYHA => Quaqtaq 
CYHB => Hudson Bay 
CYHD => Dryden Драйден
CYHE => Hope 
CYHF => Hearst 
CYHH => Nemiscau 
CYHI => Holman 
CYHK => Gjoa Haven 
CYHM => Hamilton Гамильтон
CYHN => Hornepayne 
CYHO => Hopedale 
CYHR => Chevery 
CYHT => Haines Junction 
CYHU => Montreal Монреаль
CYHY => Hay River 
CYHZ => Halifax Галифакс
CYIB => Atikokan 
CYID => Digby 
CYIF => Pakuashipi 
CYIK => Ivujivik 
CYIO => Pond Inlet 
CYIV => Island Lk/Garden Hill 
CYJF => Fort Liard 
CYJN => St Jean 
CYJP => Jasper-hinton 
CYJQ => Bella Bella 
CYJT => Stephenville 
CYKA => Kamloops Камлупс
CYKC => Collins Bay 
CYKD => Aklavik 
CYKD => Kincardine 
CYKF => Kitchener/Waterloo 
CYKG => Kangiqsujuaq 
CYKJ => Key Lake 
CYKL => Schefferville 
CYKO => Akulivik 
CYKQ => Waskaganish 
CYKX => Kirkland Lake 
CYKY => Kindersley 
CYKZ => Toronto Торонто
CYLA => Aupaluk 
CYLB => Big Creek Биг-Крик
CYLB => Lac Biche 
CYLC => Kimmirut/Lake Harbour 
CYLD => Chapleau 
CYLH => Lansdowne House 
CYLJ => Meadow Lake 
CYLL => Lloydminster, AB 
CYLO => Shilo 
CYLP => Mingan 
CYLQ => La Tuque 
CYLR => Leaf Rapids 
CYLT => Alert 
CYLU => Kangiqsualujjuaq 
CYLW => Kelowna, BC 
CYMA => Mayo 
CYMD => Mould Bay 
CYME => Matane 
CYMG => Manitouwadge 
CYMJ => Moose Jaw 
CYML => Murray Bay, NT 
CYMM => Fort Mcmurray 
CYMO => Moosonee 
CYMT => Chibougamau 
CYMU => Umiujaq 
CYMW => Maniwaki 
CYMX => Montreal Монреаль
CYNA => Natashquan 
CYNC => Wemindji 
CYND => Ottawa Оттава
CYNE => Norway House 
CYNL => Points North Landing, Saskatchewan 
CYNM => Matagami 
CYOC => Old Crow 
CYOD => Cold Lake 
CYOH => Oxford House 
CYOJ => High Level 
CYOO => Oshawa 
CYOP => Rainbow Lake 
CYOS => Owen Sound Оуэн Саунд
CYOW => Ottawa Оттава
CYOY => Valcartier 
CYPA => Prince Albert, SK 
CYPC => Paulatuk 
CYPD => Parry Sound 
CYPD => Port Hawkesbury 
CYPE => Peace River 
CYPG => Portage La Prairie 
CYPH => Inukjuak 
CYPL => Pickle Lake 
CYPM => Pikangikum 
CYPN => Port Menier 
CYPO => Peawanuck 
CYPP => Pine Point 
CYPQ => Peterborough 
CYPR => Prince Rupert Принц Руперт
CYPW => Powell River 
CYPX => Povungnituk 
CYPY => Fort Chipewyan 
CYPZ => Burns Lake 
CYQA => Muskoka 
CYQB => Quйbec City 
CYQD => The Pas 
CYQF => Red Deer 
CYQG => Windsor Виндзор
CYQH => Watson Lake 
CYQI => Yarmouth 
CYQK => Kenora 
CYQL => Lethbridge Летбридж
CYQN => Nakina 
CYQQ => Comox 
CYQR => Regina, Saskatchewan 
CYQS => St Thomas 
CYQT => Thunder Bay Тандер Бэй
CYQU => Grande Prairie 
CYQV => Yorkton Йорктон
CYQW => North Battleford 
CYQX => Gander 
CYQY => Sydney, NS 
CYQZ => Quesnel Кеснел
CYRA => Rae Lakes 
CYRB => Resolute 
CYRI => Riviere Du Loup 
CYRJ => Roberval 
CYRL => Red Lake 
CYRM => Rocky Mountain House 
CYRO => Ottawa Оттава
CYRQ => Trois-Rivieres 
CYRS => Red Sucker Lake 
CYRT => Rankin Inlet, NT 
CYRV => Revelstoke Ревелстоук
CYSA => Sable Island 
CYSB => Sudbury 
CYSC => Sherbrooke 
CYSD => Suffield 
CYSE => Squamish 
CYSF => Stony Rapids 
CYSH => Smith Falls 
CYSJ => Saint John Сент Джон
CYSK => Sanikiluaq 
CYSL => St Leonard 
CYSM => Fort Smith 
CYSN => St Catharines 
CYSP => Marathon Марафон
CYSR => Nanisivik 
CYST => Ste Therese Point 
CYSU => Summerside 
CYSV => Saglek 
CYSY => Sachs Harbour 
CYTA => Pembroke 
CYTE => Cape Dorset 
CYTF => Alma 
CYTH => Thompson 
CYTI => Triple Island 
CYTJ => Terrace Bay 
CYTL => Big Trout 
CYTQ => Tasiujuaq 
CYTR => Trenton 
CYTS => Timmins, ON 
CYTZ => Toronto Торонто
CYUB => Tuktoyaktuk 
CYUL => Montreal Монреаль
CYUT => Repulse Bay 
CYUX => Hall Beach 
CYUY => Rouyn-Noranda, Quйbec 
CYVB => Bonaventure 
CYVC => La Ronge 
CYVG => Vermilion 
CYVK => Vernon B. C. 
CYVM => Qikiqtarjuaq 
CYVP => Kuujjuaq 
CYVQ => Norman Wells 
CYVR => Vancouver, British Columbia 
CYVT => Buffalo Narrows 
CYVV => Wiarton, ON 
CYVZ => Deer Lake 
CYWA => Petawawa 
CYWG => Winnipeg Виннипег
CYWH => Victoria Лимбе
CYWJ => Deline 
CYWK => Wapolu 
CYWK => Wabush 
CYWL => Williams Lake 
CYWO => Lupin 
CYWP => Webequie 
CYWR => White River 
CYWY => Wrigley 
CYXC => Cranbrook 
CYXD => Edmonton Едмонтон
CYXE => Saskatoon Саскатун
CYXH => Medicine Hat Медисин Хет
CYXJ => Fort St John 
CYXK => Rimouski 
CYXL => Sioux Lookout 
CYXN => Whale Cove 
CYXP => Pangnirtung 
CYXQ => Beaver Creek 
CYXR => Earlton 
CYXS => Prince George Принс Джордж
CYXT => Terrace, BC 
CYXX => Abbotsford 
CYXY => Whitehorse, Yukon 
CYXZ => Wawa 
CYYB => North Bay Норт Бэй
CYYC => Calgary, AB 
CYYD => Smithers 
CYYE => Fort Nelson 
CYYF => Penticton Пентинктон
CYYG => Charlottetown 
CYYH => Taloyoak 
CYYI => Rivers 
CYYJ => Victoria Лимбе
CYYL => Lynn Lake 
CYYM => Cowley 
CYYN => Swift Current 
CYYR => Ghazvin 
CYYR => Goose Bay 
CYYU => Kapuskasing 
CYYW => Armstrong 
CYYY => Mont Joli 
CYYZ => Sargodha Саргодха
CYYZ => Toronto Торонто
CYZA => Ashcroft 
CYZE => Gore Bay 
CYZF => Yellowknife 
CYZG => Salluit 
CYZH => Slave Lake 
CYZP => Sandspit 
CYZR => Sarnia 
CYZS => Coral Harbour 
CYZT => Port Hardy 
CYZU => Whitecourt 
CYZV => Sept-Iles 
CYZW => Teslin 
CYZX => Greenwood 
CZAC => York Landing 
CZAM => Salmon Arm 
CZBB => Vancouver Ванкувер
CZBD => Ilford 
CZBF => Bathurst Батерст
CZBM => Bromont 
CZEE => Kelsey 
CZEM => East Main 
CZFA => Faro Фаро
CZFD => Fond Du Lac 
CZFG => Pukatawagan 
CZFM => Fort Mcpherson 
CZFN => Tulita/Fort Norman 
CZGF => Grand Forks 
CZGI => Gods River 
CZGR => Little Grand Rapids 
CZHP => High Prairie 
CZJG => Jenpeg 
CZJN => Swan River 
CZKE => Kaschechewan 
CZLQ => Thicket Portage 
CZMD => Muskrat Dam 
CZML => 108 Mile Ranch 
CZMN => Pikwitonei 
CZMT => Masset 
CZNG => Poplar River 
CZPB => Sachigo Lake 
CZPC => Pincher Creek 
CZPO => Pine House 
CZRJ => Round Lake 
CZSJ => Sandy Lake 
CZSN => South Indian Lake 
CZST => Stewart 
CZTA => Bloodvein 
CZTM => Shamattawa 
CZUC => Ignace 
CZUM => Churchill Falls 
CZWH => Lac Brochet 
CZWL => Wollaston Lake 
DAAD => Boussaada 
DAAE => Bejaia 
DAAG => Algiers 
DAAJ => Djanet 
DAAP => Illizi Иллизи
DAAS => Setif 
DAAT => Tamanrasset Таманрассет
DAAV => Jijel 
DABB => Annaba 
DABC => Constantine 
DABP => Skikda Скикда
DABS => Tbessa Тбесса
DABT => Batna Батна
DAOB => Tiaret Тиарет
DAOF => Tindouf Тиндуф
DAOL => Oran Оран
DAON => Tlemcen 
DAOO => Oran Оран
DAOR => Bechar 
DAOV => Zhairem Жайрем
DAOV => Horizontina 
DAOV => Mascara Маскара
DATG => In Guezzam Ин-Геззам
DATM => Bordj Badji Mokhtar Борж-Бажи-Мохтар
DAUA => Adrar 
DAUB => Biskra Бискра
DAUE => El Golea Эль-Голеа
DAUG => Ghardaia 
DAUH => Hassi Messaoud 
DAUI => In Salah Ин-Салах
DAUK => Touggourt 
DAUO => El Oued 
DAUT => Timimoun Тимимун
DAUU => Ouargla Уаргла
DAUZ => In Amenas 
DBBB => Cotonou 
DBBD => Djougou Джугу
DBBK => Kandi Канди
DBBN => Natitingou Натитингу
DBBP => Parakou Параку
DBBS => Save Саве
DFCA => Kaya Кайя
DFCC => Ouahigouya Уахигоуя
DFCJ => Djibo Джибо
DFCL => Leo Лео
DFCP => Po По
DFEA => Boulsa Булса
DFEB => Bogande Боганд
DFED => Diapaga Диапага
DFEE => Dori Дори
DFEF => Fada Ngourma Фада-Нгурма
DFEG => Gorom-Gorom 
DFEL => Kantchari Канчари
DFEM => Tambao Тамбао
DFEP => Pama Пама
DFER => Arly Арли
DFES => Sebba Себба
DFET => Tenkodogo Тенкодого
DFEZ => Zabre Забре
DFFD => Ouagadougou Уагадугу
DFOB => Banfora Банфора
DFOD => Dedougou Дедугу
DFOG => Gaoua Гауа
DFON => Nouna 
DFOO => Bobo Dioulasso 
DFOT => Tougan Туган
DFOU => Diebougou Диебугу
DFOY => Aribinda Арибинда
DGAA => Accra 
DGAA => Kamberatoro 
DGLE => Tamale Тамале
DGSI => Kumasi Кумаси
DGSN => Sunyani Суньяни
DGTK => Takoradi Такоради
DIAO => Aboisso 
DIAP => Abidjan Абиджан
DIAP => Falls Bay 
DIAP => Habi 
DIAU => Abengourou 
DIBI => Boundiali 
DIBK => Bouake 
DIBN => Bouna 
DIBU => Bondoukou 
DIDK => Dimbokro 
DIDL => Daloa 
DIDV => Divo 
DIFK => Ferkessedougou 
DIGA => Gagnoa 
DIGL => Guiglo 
DIGN => Bereby 
DIKO => Korhogo 
DIMN => Man 
DIOD => Odienne 
DIOF => Ouango Fitini 
DISG => Seguela 
DISP => San Pedro Сан-Педро
DISS => Sassandra 
DITB => Tabou 
DITM => Touba 
DIYO => Yamoussoukro 
DNAA => Abuja Абуджа
DNAK => Akure Акере
DNBE => Benin City Бенин-Сити
DNCA => Calabar Калабар
DNEN => Enugu Энугу
DNGU => Guarapari 
DNIB => Ibadan Ибадан
DNIL => Ilorin Илорин
DNJO => Jos Йос
DNKA => Kaduna Кадуна
DNKN => Kano Кано
DNMA => Maiduguri Майдугури
DNMK => Makurdi Макурди
DNMM => Lagos Лагос
DNMN => Minna Минна
DNPO => Port Harcourt 
DNSO => Sokoto Сокото
DNYO => Langley 
DNYO => Yola Йола
DNZA => Zaria Зариа
DRRB => Birni Nkoni 
DRRM => Maradi Маради
DRRN => Niamey Ниамей
DRRT => Tahoua Тахуа
DRZA => Agades 
DRZL => Arlit Арлит
DRZR => Zinder Зиндер
DTKA => Tabarka Табарка
DTMB => Monastir Монастир
DTTA => Tosontsengel 
DTTA => Tunis Тунис
DTTF => Gafsa Гафса
DTTG => Gabes Габес
DTTJ => Djerba Джерба
DTTR => El Borma Эль-Борма
DTTV => Death Valley Долина Смерти
DTTX => Sfax Сфакс
DTTZ => Tozeur Тозер
DXNG => Niamtougou 
DXXX => Lome 
EBAW => Antwerp Антверпен
EBBR => Brussels Брюссель
EBCI => Brussels Брюссель
EBKT => Kortrijk 
EBKW => Knokke/Het Zoute 
EBKW => Rochester Рочестер
EBLG => Lake Gregory 
EBLG => Liege Льеж
EBLG => Latacunga 
EBOS => Ostend 
EBPW => Phongsaly 
EBZR => Zoersel 
EDAC => Altenburg Альтенбург
EDAH => Heringsdorf Херингсдорф
EDAL => Coffee Point 
EDAX => Rechlin 
EDBC => Cochstedt 
EDBH => Barth Барт
EDBI => Tai Shan 
EDBI => She Kou 
EDBI => Glasgow 
EDBI => Kuching Кучинг
EDBI => Salina 
EDBI => Panarea 
EDBI => Procida 
EDBI => Chek Lap Kok 
EDBI => Stromboli 
EDBI => Ponza Понза
EDBI => Shekou 
EDBI => Syracuse Сиракус
EDCD => Cottbus Коттбус
EDCG => Guettin Гюттин
EDDB => Berlin Берлин
EDDC => Dresden Дрезден
EDDE => Erfurt Эрфурт
EDDF => Frankfurt Франкфурт-на-Майне
EDDF => Rosh Pina Рош Пина
EDDG => Muenster/Osnabrueck 
EDDH => Hamburg Гамбург
EDDI => Berlin Берлин
EDDK => Cologne Кельн
EDDL => Dusseldorf Дюссельдорф
EDDL => Ronda Ронда
EDDM => Munich Мюнхен
EDDP => Leipzig-halle 
EDDR => Saarbruecken 
EDDS => Stuttgart Штуттгард
EDDT => Berlin Берлин
EDDV => Hanover Ганновер
EDDW => Bremen Бремен
EDFH => Hahn 
EDFM => Mannheim Маннхайм
EDGS => Siegen Зиген
EDHI => Hamburg Гамбург
EDHK => Kiel Киел
EDHL => Lьbeck 
EDHN => Neumuenster Ноймюнстер
EDIU => Heidelberg Хайдельберг
EDKA => Aachen Аахен
EDLE => Essen Эссен
EDLI => Bielefeld Билефельд
EDLN => Moenchengladbach 
EDLP => Paderborn 
EDLV => Dusseldorf Дюссельдорф
EDLW => Dortmund Дортмунд
EDMA => Munich Мюнхен
EDMO => Oberpfaffenhofen 
EDMS => Straubing 
EDNY => Friedrichshafen Фридрихшафен
EDOL => Frankfurt Франкфурт-на-Майне
EDOM => Kalaleh 
EDOP => Schwerin Шверин
EDQC => Foshan Фошан
EDQD => Bayreuth Байройт
EDQM => Hof Хоф
EDRB => Bitburg Битбург
EDSB => Karlsruhe/Baden Baden Карлсруэ
EDTL => Lahr Лар
EDTN => Tinboli 
EDVE => Braunschweig Брауншвайг
EDVK => Kassel Кассел
EDWB => Bremerhaven Бременхавен
EDWD => Lemwerder 
EDWE => Emden Эмден
EDWG => Wangerooge Вангерооге
EDWI => Wilhelmshaven 
EDWJ => Juist Юист
EDWL => Langeoog Лангеоог
EDWR => Borkum Боркум
EDWS => Norddeich Норддайх
EDWU => Varrelbusch Варрельбух
EDWY => Norderney Нордерней
EDWZ => Baltrum Island 
EDXB => Heide-Buesum 
EDXF => Flensburg Фленсбург
EDXH => Helgoland Хелголанд
EDXO => St Peter 
EDXQ => Wasum 
EDXW => Westerland 
EDXY => Itauba 
EDXY => Aumo 
EDXY => Wyk Auf Foehr 
EEKA => Kardla Кярдла
EEKE => Kuressaare Курессааре
EEPU => Parnu Парну
EETN => Tallinn Таллинн
EETU => Tartu Тарту
EFET => Enontekio Енонтекио
EFHA => Kuorevesi 
EFHF => Helsinki Хельсинки
EFHK => Vantaa 
EFHV => Hyvinkaa Хивинкаа
EFIT => Kitee 
EFIV => Ivalo Ивало
EFJO => Joensuu Йонсуу
EFJY => Jyvaskyla Ювяскюля
EFKA => Kauhava Каухава
EFKE => Kemi/Tornio 
EFKI => Kajaani Каяне
EFKJ => Kauhajoki Каухайоки
EFKK => Kokkola/Pietarsaari 
EFKS => Kuusamo Кусамо
EFKT => Kittila Киттила
EFKU => Kuopio Куопио
EFLP => Lappeenranta Лаппенранта
EFMA => Mariehamn Мариехамн
EFMI => Mikkeli Миккели
EFOU => Cacoal 
EFOU => Oulu Оулу
EFPO => Pori Пори
EFRO => Rovaniemi Рованиеми
EFSA => Savonlinna Савонлинна
EFSI => Seinajoki Сейнайоки
EFSO => Sodankyla Соданкюля
EFTP => Tampere Тампере
EFTU => Turku Турку
EFUT => Valkeala 
EFVA => Vaasa Васа
EFVR => Joroinen 
EFYL => Ylivieska 
EGAA => Belfast 
EGAB => Enniskillen 
EGAC => Belfast 
EGAE => Derry 
EGBB => Birmingham 
EGBE => Coventry 
EGBJ => Gloucester Глучестер
EGBK => Northampton 
EGBN => Nottingham 
EGCC => Manchester Манчестер
EGCN => Arapoti 
EGCN => Doncaster Sheffield 
EGDG => Newquay 
EGDJ => Upavon 
EGDL => Lyneham 
EGDY => Yeovilton Йовилтон
EGEC => Campbeltown Кемпбелтаун
EGED => Eday Эдей
EGEF => Fair Isle Фейр-Айсл
EGEH => Whalsay Волсей
EGEN => North Ronaldsay 
EGEO => Oban Обан
EGEP => Bethpage 
EGEP => Papa Westray Папа-Вестрей
EGER => Stronsay Стронсей
EGES => Sanday 
EGET => Shetland Islands 
EGEW => Westray Вестрей
EGFE => Haverfordwest 
EGFF => Cardiff 
EGFH => Swansea Суони
EGGD => Bristol Бристоль
EGGP => Liverpool Ливерпуль
EGGW => Luton 
EGHC => Lands End 
EGHD => Plymouth 
EGHE => Isles Of Scilly 
EGHH => Bournemouth 
EGHI => Eastleigh near Southampton 
EGHJ => Bembridge 
EGHK => Penzance 
EGHT => Isles Of Scilly 
EGJA => Alderney Элдерни
EGJB => Guernsey Гернси
EGJJ => Jersey Джерси
EGKA => Brighton 
EGKA => Shoreham By Sea 
EGKB => Biggin Hill 
EGKK => London Лондон
EGLC => London Лондон
EGLF => Farnborough 
EGLK => Yateley 
EGLL => London Лондон
EGMC => Southend 
EGMH => Manston 
EGNC => Carlisle Карлисл
EGNH => Blackpool 
EGNJ => Humberside Хамберсайд
EGNL => Barrow-In-Furness 
EGNL => Little Naukati 
EGNM => Leeds 
EGNM => Mont Tremblant Мон Тремблан
EGNR => Chester Честер
EGNS => Isle Of Man 
EGNT => Newcastle Ньюкасл
EGNV => Teesside, Durham 
EGNV => Mount Cook Маунт Кук
EGNX => Drift River 
EGNX => Derby 
EGOV => Holyhead 
EGPA => Orkney Island 
EGPB => Shetland Islands 
EGPC => Wick Вик
EGPC => Al Koude 
EGPD => Aberdeen 
EGPE => Inverness 
EGPF => Glasgow 
EGPH => Edinburgh Эдинбург
EGPI => Islay 
EGPK => Prestwick, South Ayrshire 
EGPL => Benbecula 
EGPM => Shetland Islands 
EGPN => Dundee Данди
EGPO => Stornoway 
EGPR => Barra 
EGPT => Perth Перт
EGPU => Tiree 
EGPW => Unst Shetland Is 
EGQB => Bally Kelly 
EGQK => Forres Форрес
EGQL => St Andrews 
EGQS => Lossiemouth 
EGSB => Marshall Маршалл
EGSC => Cambridge Кембрдидж
EGSH => Norwich Норвич
EGSS => London Лондон
EGSY => Sheffield Шеффилд
EGTE => Exeter Эксетер
EGTG => Bristol Бристоль
EGTK => Oxford Оксфорд
EGTO => Rochester Рочестер
EGUB => Benson 
EGUD => Abingdon Абингдон
EGUH => High Wycombe Хай-Вайкомб
EGUL => Brandon Брэндон
EGUN => Mildenhall Милденхолл
EGUN => Mildenhall Милденхолл
EGVA => Fairford 
EGVF => Portsmouth Портсмут
EGVN => Oxford Оксфорд
EGVO => Odiham 
EGVT => Braintree 
EGWA => Andover Эндовер
EGWU => Northolt 
EGXB => Grimsby Гримсби
EGXH => Bury St Edmunds 
EGXJ => Oakham 
EGXP => Scampton 
EGXQ => New York Нью-Йорк
EGXU => Harrogate Херрогейт
EGXU => Northeast Cape 
EGXU => Onion Bay 
EGXU => Bobadilla 
EGXU => Montilla 
EGYM => Kings Lynn 
EGYP => Mount Pleasant Маунт-Плезант
EHAM => Amsterdam Амстердам
EHBK => Maastricht Маастрихт
EHBK => Dundee Данди
EHBK => Schenectady 
EHBK => Humen 
EHBK => Boston Бостон
EHBK => Boston Бостон
EHBK => Lisbon Лиссабон
EHEH => Eindhoven Эйндховен
EHGG => Groningen Гронинген
EHGR => Breda Бреда
EHKD => Den Helder 
EHLE => Lelystad Лелистад
EHLW => Leeuwarden Лиуварден
EHRD => Rotterdam Роттердам
EHSB => Utrecht Утрехт
EHTW => Enschede Энсхеде
EHVB => Leiden Лейден
EHVK => Uden 
EHWO => Bergen Op Zoom Берген Оп Зоом
EIBN => Bantry Бантри
EIBT => Belmullet Белмаллет
EICA => Spiddal 
EICB => Castlebar Кастлбар
EICD => Wexford Уэксфорд
EICK => Cork Корк
EICM => Galway Голуэй
EIDL => Carrickfinn 
EIDW => Dublin Дублин
EIIM => Inishmore Инишмор
EIIR => Inisheer Инишир
EIKL => Kilkenny Килкенни
EIKN => Knock Нок
EIKY => Farranfore 
EILT => Letterkenny Леттеркенни
EIMN => Galloway 
EINN => Shannon Шеннон
EISG => Sligo Слайго
EIWF => Waterford Вотерфорд
EKAH => Aarhus Аарус
EKBI => Billund Биллунд
EKCH => Copenhagen Копенгаген
EKEB => Esbjerg Эсбьерг
EKKA => Karup Каруп
EKLS => Laeso Island 
EKMB => Maribo 
EKOD => Odense Оденсе
EKRK => Copenhagen Копенгаген
EKRN => Rшnne 
EKSB => Sonderborg Сондерборг
EKSN => Sindal Зиндаль
EKSP => Vojens 
EKSV => Skive 
EKTS => Thisted Тистед
EKVG => Sorvag 
EKVJ => Skjern 
EKYT => Aalborg Аальбург
ELLX => Luxembourg Люксембург
ENAL => Aalesund 
ENAN => Andenes Анденес
ENAT => Alta Алта
ENBL => Forde Форде
ENBN => Bronnoysund Броннойзунд
ENBO => Bodo Бодо
ENBR => Bergen Берген
ENBS => Batsfjord Ботсфьорд
ENBV => Berlevag Берлевог
ENCN => Kristiansand Кристиансенд
ENDI => Geilo Гейло
ENDU => Bardufoss Бордуфос
ENEV => Harstad-narvik 
ENFG => Fagernes Фагернес
ENFL => Floro Флоро
ENGM => Oslo Осло
ENHA => Hamar Хамар
ENHD => Haugesund Хаугезунд
ENHF => Hammerfest Хаммерфест
ENHK => Hasvik Хасвик
ENHV => Honningsvag Хоннигсвог
ENKB => Kristiansund Кистиансанд
ENKR => Kirkenes Киркенес
ENLI => Farsund Фарсунд
ENLK => Leknes Лекнес
ENMH => Mehamn Мехамн
ENML => Molde Молде
ENMS => Mosjoen Мосьоэн
ENNA => Lakselv 
ENNK => Narvik Нарвик
ENNM => Namsos Намсус
ENNO => Notodden Нутодден
ENOL => Orland Орланд
ENOV => Orsta-Volda 
ENQO => Havadarya 
ENRA => Mo I Rana 
ENRM => Roervik 
ENRO => Roros Ророс
ENRS => Rost 
ENSB => Longyearbyen Лонгербьен
ENSD => Sandane 
ENSG => Sogndal Сондал
ENSH => Svolvaer Сволваер
ENSK => Stokmarknes 
ENSN => Skien Скиен
ENSO => Stord Сторд
ENSR => Sorkjosen Соркьосен
ENSS => Vardoe 
ENST => Sandnessjoen Санднессьоен
ENTC => Tromso Тромсо
ENTO => Torp 
ENUK => Gol Гол
ENVA => Trondheim Трондхайм
ENVD => Vadso Вадсо
ENVR => Vaeroy Верой
ENZV => Stavanger Ставангер
EPBY => Bydgoszcz Быдгощ
EPCH => Czestochowa Щесточова
EPDA => Harrisburg 
EPGD => Gdansk Гданьск
EPGI => Katukurunda 
EPKK => Krakow Краков
EPKO => Koszalin Кошалин
EPKT => Katowice Катовице
EPLL => Lodz Лодзь
EPPO => Poznan Познан
EPRZ => Rzeszow Жешув
EPSC => Szczecin Щецин
EPSK => Slupsk Слупск
EPSY => Szymany 
EPWA => Warsaw Варшава
EPWR => Wroclaw Вроцлав
EPZG => Zielona Gora Зелена-Гора
ESDF => Ronneby Роннеби
ESFA => Hassleholm 
ESFR => Tortola 
ESGG => Gothenburg Готенбург
ESGJ => Jonkoping Йонкопинг
ESGL => Lidkoping Лидкопинг
ESGP => Gothenburg Готенбург
ESGR => Skovde Сковде
ESGT => Trollhattan Тролльхеттан
ESHH => Angelholm/Helsingborg 
ESHM => Malmo Малмо
ESKK => Karlskoga Карлскуга
ESKM => Mora Мора
ESKN => Stockholm Стокгольм
ESMK => Kristianstad Кристианстад
ESMO => Oskarshamn Оскархамн
ESMQ => Kalmar Калмар
ESMS => Malmo Малмо
ESMT => Halmstad Халмстад
ESMX => Vдxjц 
ESND => Sveg Свег
ESNG => Gallivare Галливаре
ESNH => Hudiksvall Худиксвалл
ESNK => Kramfors Крамфорс
ESNL => Lycksele Ликселе
ESNN => Sundsvall Сандсвалль
ESNO => Ornskoldsvik Орнсколдсвик
ESNQ => Kiruna Кируна
ESNS => Skelleftea Скеллефти
ESNU => Umea Умео
ESNV => Vilhelmina Вилхелмина
ESNX => Arvidsjaur Арвидсьяур
ESNY => Soderhamn Содерхамн
ESNZ => Ostersund Остерсанд
ESOE => Orebro Оребро
ESOH => Hagfors Хагфорс
ESOK => Karlstad Карлстад
ESOW => Stockholm Стокгольм
ESPA => Lulea Лули
ESSA => Stockholm Стокгольм
ESSB => Stockholm Стокгольм
ESSD => Borlange Борланг
ESSF => Hultsfred Хултсфред
ESSK => Gavle Гавле
ESSL => Linkoping Линкопинг
ESSP => Norrkoping Ноггкопинг
ESST => Torsby 
ESSU => Eskilstuna Эскилстуна
ESSV => Visby Висби
ESSW => Vastervik Вастервик
ESTA => Angelholm/Helsingborg 
ESUD => Storuman Сторуман
ESUE => Idre Идре
ESUP => Pajala 
ESUT => Hemavan 
ETAD => Spangdahlem 
ETAR => Ramstein Рамштайн
ETAS => Sembach 
ETED => Kaiserslautern Кайзерслаутен
ETHF => Fritzlar 
ETIK => Illisheim 
ETMN => Nordholz-Spieka 
ETNG => Geilenkirchen Гайленкирхен
ETNL => Rostock-laage 
ETNS => Schleswig-jagel 
ETNU => Neubrandenburg 
ETOU => Wiesbaden Висбаден
ETSF => Fuerstenfeldbruck 
ETSI => Ingolstadt-manching 
ETUL => Laarbruch Лаарбух
ETUO => Guetersloh 
ETUR => Brueggen 
EVDA => Daugavpils Даугавпилс
EVLA => Liepaya Лиепая
EVRA => Riga Рига
EYKA => Kaunas Каунас
EYPA => Klaipeda/Palanga 
EYPP => Panevezys 
EYSA => Siauliai 
EYVI => Vilnius Вильнюс
FAAB => Alexander Bay Александер-Бей
FAAG => Aggeneys Аггенейз
FAAL => Alldays Оллдейз
FABE => Bisho Бишо
FABU => Butterworth Баттерворт
FACD => Cradock Крадок
FACT => Cape Town Кейптаун
FACT => Kondubol 
FACT => Yangoonabie 
FADK => Dukuduk 
FADN => Durban Дурбан
FADQ => Phinda 
FAEL => East London Ист-Лондон
FAEM => Empangeni Эмпангени
FAER => Ellisras Эллисрас
FAFB => Ficksburg Фиксбург
FAGC => Johannesburg Йоханнесбург
FAGG => George Джордж
FAGI => Giyani 
FAGM => Johannesburg Йоханнесбург
FAHL => Hluhluwe Хлухлуве
FAHR => Harrismith Харрисмит
FAHS => Hoedspruit 
FAHW => Hazyview Хезивью
FAJS => Teniente R. Marsh Martin 
FAKD => Klerksdorp Клерксдорп
FAKM => Kimberley Кимберли
FAKN => Nelspruit Нельспрут
FAKP => Komatipoort 
FAKU => Kuruman Куруман
FAKZ => Kleinzee Кляйнзи
FALA => Lanseria Лансерия
FALC => Lime Acres Лайм-Акрес
FALD => Londolozi 
FALK => Lusikisiki Лусикисики
FALO => Louis Trichardt Луи-Тришар
FALW => Saldanha Bay 
FALY => Ladysmith Ледисмит
FAMD => Mala Mala Мала-Мала
FAMG => Margate Маргейт
FAMM => Mmabatho 
FAMN => Malelane Малелейн
FAMO => Mossel Bay Залив Моссел
FAMU => Mkuze Мкуз
FAMW => Mzamba(Wild Coast Sun) 
FANC => Newcastle Ньюкасл
FANS => Nelspruit Нельспрут
FAOH => Oudtshoorn Оудсхорн
FAPA => Port Alfred Порт Альфред
FAPE => Port Elizabeth Порт Элизабет
FAPG => Plettenberg Bay Плеттенберг-Бей
FAPH => Phalaborwa Фалаборва
FAPJ => Port Saint Johns 
FAPK => Prieska 
FAPM => Pietermaritzburg Питермарицбург
FAPN => Sun City Сан Сити
FAPP => Polokwane 
FAQT => Queenstown Куинстаун
FARB => Richards Bay Ричардс-Бей
FARI => Reivilo Рейвило
FARS => Robertson 
FASB => Springbok Спрингбок
FASC => Secunda 
FASS => Sishen Сишен
FASZ => Skukuza Скукуза
FATD => Tanda Tula Танда Тула
FATH => Thohoyandou 
FATN => Thaba Nchu 
FATZ => Tzaneen Цанин
FAUL => Ulundi Улунди
FAUP => Upington Упингтон
FAUT => Umtata Умтата
FAVB => Vryburg Врибург
FAVG => Durban Дурбан
FAVR => Vredendal Вредендаль
FAVY => Vryheid Врихейд
FAWB => Pretoria Претория
FAWM => Welkom Велком
FBFT => Francistown Франсистаун
FBGZ => Ghanzi Ганзи
FBJW => Jwaneng Жваненг
FBKE => Kasane Касане
FBKR => Khwai River Lodge 
FBKR => Leshukonskoye Лешуконское
FBMN => Maun Мон
FBOR => Orapa Орапа
FBSK => Gaborone Габороне
FBSN => Suapan 
FBSP => Selebi-Phikwe 
FBSW => Shakawe 
FBTL => Tuli Block 
FBTS => Tsabong 
FBXB => Paris Париж
FBXB => Baqubah 
FCBB => Brazzaville 
FCBD => Djambala Джамбала
FCBK => Kindamba Киндамба
FCBL => Lague 
FCBM => Mouyondzi Муйондзи
FCBS => Sibiti Сибити
FCBY => Nkayi Нкайи
FCBZ => Zanaga Занага
FCBZ => Naples Неаполь
FCBZ => Bintulu Бинтулу
FCMM => Mossendjo 
FCOB => Boundji Бунджи
FCOE => Ewo Эво
FCOG => Gamboma Гамбома
FCOI => Impfondo Импфондо
FCOK => Kelle Келле
FCOM => Makoua Макуа
FCOO => Owando 
FCOS => Souanke Суанке
FCOT => Betou Бету
FCOU => Ouesso Уэссо
FCPA => Makabana Макабана
FCPE => Lekana Лекана
FCPL => Loubomo 
FCPP => Beeville 
FCPP => Pointe Noire Пуэнт-Нуар
FDMS => Manzini 
FEFC => Carnot Карнот
FEFF => Bangui 
FEFG => Bangassou Бангассу
FEFI => Birao 
FEFL => Bossembele Боссембеле
FEFM => Bambari Бамбари
FEFN => Ndele Нделе
FEFO => Bouar Буар
FEFR => Bria Бриа
FEFS => Bossangoa Боссанга
FEFT => Berberati Берберати
FEFW => Ouadda Уадда
FEFY => Yalinga Ялинга
FEFZ => Zemio 
FEGF => Batangafo Батангафо
FEGL => Gordil Гордил
FEGM => Bakouma Бакума
FEGO => Ouanda Djalle Уанда-Джалле
FEGR => Rafai Рафаи
FEGU => Bouca Бука
FEGZ => Bozoum Бозум
FGBT => Bata Бата
FGSL => Malabo Малабо
FHAW => Araak 
FHAW => Georgetown, Ascension Island 
FIMP => Plaisance 
FIMR => Rodrigues Is 
FKAN => Nkongsamba 
FKKB => Kribi Криби
FKKC => Tiko Тико
FKKD => Douala Дуала
FKKF => Mamfe Мамфе
FKKH => Kaele Келе
FKKI => Batouri Батури
FKKJ => Yagoua Ягуа
FKKL => Maroua 
FKKM => Foumban Фумбан
FKKM => Koutaba Кутаба
FKKN => Ngaoundere 
FKKO => Yaoundй 
FKKR => Garoua Гаруа
FKKS => Dschang Дшанг
FKKU => Bafoussam 
FKKV => Bamenda 
FKKW => Ebolowa Эболова
FKKY => Yaounde Яунде
FKYS => Yaounde Яунде
FLBA => Mbala 
FLCP => Chipata Чипата
FLKE => Kasompe 
FLKL => Kalabo Калабо
FLKO => Kaoma 
FLKS => Kasama Касама
FLKY => Kasaba Bay Касаба-Бей
FLLI => Livingstone Ливингстоун
FLLK => Lukulu Лукулу
FLLS => Lusaka 
FLMA => Mansa Манса
FLMF => Mfuwe Мфуве
FLMG => Mongu Монгу
FLNA => Ngoma Нгома
FLND => Ndola 
FLSN => Senanga Сенанга
FLSO => Kitwe Китве
FLSS => Sesheke Сешеке
FLSW => Solwezi Солвези
FLZB => Zambezi Замбези
FMCH => Moroni 
FMCI => Moheli Моэли
FMCN => Moroni 
FMCV => Anjouan Анжуан
FMCZ => Dzaoudzi 
FMEE => St Denis de la Reunion 
FMEP => St Pierre dela Reunion 
FMMC => Malaimbandy Малаимбанди
FMME => Antsirabe Анцирабе
FMMG => Antsalova Антсалова
FMMH => Mahanoro Маханору
FMMI => Antananarivo 
FMMK => Ankavandra Анкавандра
FMML => Belo Бело
FMMN => Miandrivazo Миандривацо
FMMO => Maintirano Майнтирано
FMMQ => Ilaka Илака
FMMQ => Ilo 
FMMR => Morafenobe Морафенобе
FMMS => Sainte Marie 
FMMT => Tamatave Таматаве
FMMU => Tambohorano Тамбохорано
FMMV => Morondava Морондава
FMMX => Tsiroanomandidy Тсироаномандиди
FMMY => Vatomandry Ватомандри
FMMZ => Ambatondrazaka Амбатондразака
FMNA => Antsiranana 
FMNC => Mananara Мананара
FMND => Andapa Андапа
FMNE => Ambilobe Амбилобе
FMNF => Befandriana Бефандриана
FMNG => Port Berge Порт-Бердж
FMNH => Antalaha Анталаха
FMNJ => Ambanja Амбандза
FMNL => Analalava Аналалава
FMNM => Majunga 
FMNN => Cuxhaven 
FMNN => Nossi-Be 
FMNO => Soalala Соалала
FMNP => Mampikony Мампикони
FMNQ => Besalampy Бесалампи
FMNR => Maroantsetra Мароантсера
FMNS => Sambava Самбава
FMNT => Tsaratanana Тсаратанана
FMNV => Vohemar Вохемар
FMNW => Antsohihy Антсохиху
FMNX => Mandritsara Мандритсара
FMSB => Beroroha Беророха
FMSC => Mandabe Мандабе
FMSD => Fort Dauphin Форт-Дофин
FMSF => Fianarantsoa Фианаранцоа
FMSG => Farafangana Фарафангана
FMSI => Inhaca 
FMSI => Ihosy Ихоси
FMSJ => Manja Мандза
FMSK => Manakara Манакара
FMSL => Bekily Бекили
FMSM => Mananjary Манандзари
FMSN => Tanandava Танандава
FMSR => Morombe Моромбе
FMST => Tulear Тулеар
FMSV => Betioky 
FMSY => Ampanihy Ампанихи
FMSZ => Ankazoabo Анказоабо
FNAL => Andulo Андуло
FNAM => Ambriz 
FNBG => Benguela Бенгела
FNBL => Lumbala Лумбала
FNCA => Cabinda Кабинда
FNCF => Cafunfo 
FNCH => Chitato 
FNCP => Capanda 
FNCT => Catumbela 
FNCV => Cuito Cuanavale Куито
FNCZ => Cazombo Казомбо
FNDU => Dundo Дундо
FNGI => Ngiva 
FNGI => Ongiva 
FNHU => Huambo 
FNJA => Jamba Джамба
FNKU => Kuito Куито
FNLU => Luanda 
FNMA => Malange 
FNME => Menongue Менонге
FNMO => Namibe 
FNNG => Negage Негаге
FNPA => Porto Amboim Порту-Амбоим
FNSA => Saurimo Сауримо
FNSO => Soyo Сойо
FNSU => Sumbe Сумбе
FNUA => Luau Луау
FNUB => Lubango 
FNUE => Luena 
FNUG => Uige Уиже
FNWK => Waco Kungo Вако-Кунго
FNXA => Xangongo Шангонго
FNZG => Nzagi 
FOGB => Booue 
FOGE => Ndende 
FOGF => Fougamou Фугаму
FOGG => Mbigou Мбигу
FOGI => Moabi Моаби
FOGK => Koulamoutou Куламуту
FOGM => Mouila Муила
FOGO => Oyem Оем
FOGQ => Okondja Оконджа
FOGR => Lambarene Ламбарене
FOGV => Minvoul Минвул
FOOB => Bitam Битам
FOOD => Moanda Моанда
FOOE => Mekambo Мекамбо
FOOG => Port Gentil Порт-Гентил
FOOH => Omboue Омбуэ
FOOI => Iguela Игуэла
FOOK => Makokou Макоку
FOOL => Libreville Либревилль
FOOM => Mitzic Мицик
FOON => Franceville 
FOOR => Lastourville Ластурвилль
FOOS => Sette Cama Сетте-Кама
FOOT => Tchibanga Чибанга
FOOY => Mayoumba Маюмба
FPPA => Porto Alegre Порто Алегре
FPPR => Principe 
FPST => Sao Tome Is 
FQAG => Angoche 
FQBR => Beira Бейра
FQCB => Cuamba 
FQCH => Chimoio 
FQIN => Inhambane Иньямбане
FQLC => Lichinga 
FQLU => Luabo Луабо
FQMA => Machu Picchu Мачу-Пиччу
FQMA => Maputo Мапуту
FQMD => Mueda 
FQMP => Mocimboa Praia 
FQNC => Nacala Накала
FQNP => Nampula Нампула
FQPB => Pemba 
FQQL => Quelimane Келимане
FQTE => Tete Тете
FQTT => Tete Тете
FQVL => Vilanculos Виланкулос
FQXA => Xai Xai 
FQXA => Oqatsut 
FQXA => Khan Al Baghdadi 
FQXA => Vienna Вена
FQXA => Flen 
FQXA => Karlshamn Карлсхамн
FQXA => Solvesborg 
FSDR => Desroches Десрочес
FSIA => Mahe Island Остров Махе
FSPP => Praslin Island Праслин-Айленд
FSSB => Bird Island Берд-Айленд
FSSD => Denis Island 
FSSF => Fregate Is 
FTTA => Sarh Сарх
FTTB => Bongor Бонгор
FTTC => Abecher 
FTTD => Moundou Мунду
FTTH => Lai Лей
FTTI => Ati Ати
FTTJ => Ndjamena 
FTTK => Bokoro Бокоро
FTTL => Bol Бол
FTTM => Mongo Монго
FTTN => Am Timan 
FTTP => Pala Пала
FTTS => Bousso Буссо
FTTU => Mao Мао
FTTY => Faya Файя
FTTZ => Penang Пенанг
FVBU => Bulawayo Булауайо
FVCH => Chipinge 
FVCZ => Buffalo Range 
FVFA => Victoria Falls Водопады Виктории
FVHA => Harare Хараре
FVIT => Itaperuna 
FVKB => Kariba Кариба
FVKZ => Kelaniya 
FVMU => Mutare Мутаре
FVMV => Masvingo Масвинго
FVTL => Gweru Гверу
FVWN => Hwange Nat Park 
FVWT => Hwange 
FVZK => Pan Yu 
FWCL => Blantyre 
FWCM => Club Makokola 
FWDW => Dwangwa 
FWKA => Karonga Каронга
FWKG => Kasungu Касунгу
FWKI => Lilongwe 
FWLK => Likoma Island Ликома-Айленд
FWMG => Mangochi Мангочи
FWMY => Monkey Bay 
FWSM => Salima Салима
FWUU => Mzuzu Мзузу
FXLK => Lebakeng Лебакенг
FXLR => Leribe Лерибе
FXLS => Lesobeng Лесобенг
FXMA => Matsaile Матсайле
FXMF => Mafeteng Мафетенг
FXMK => Mokhotlong Мохотлонг
FXMM => Maseru 
FXNK => Nkaus Нкаус
FXPG => Pelaneng Пеланенг
FXQG => Quthing 
FXQN => Qachas Nek 
FXSH => Sehonghong Сехонгхонг
FXSK => Sekakes Секакес
FXSM => Semongkong Семонгконг
FXSS => Seshutes Сешутес
FXTA => Thaba-Tseka 
FXTA => Torres Торрес
FXTK => Tlokoeng Тлокоэнг
FYAR => Arandis 
FYGB => Gobabis 
FYGF => Grootfontein Грутфонтейн
FYHI => Halali Халали
FYKB => Karasburg Карасбург
FYKM => Mpacha Мпача
FYKT => Keetmanshoop Китмансхуп
FYLZ => Luderitz Людериц
FYMO => Mokuti Lodge 
FYNA => Namutoni Намутони
FYOA => Ondangwa Ондангва
FYOE => Omega Омега
FYOG => Oranjemund Ораньемунд
FYOJ => Otjiwarongo Отьиваронго
FYOO => Okaukuejo Окаукуйэхо
FYOP => Opuwa Опува
FYOS => Oshakati Ошакати
FYRU => Rundu Рунду
FYSM => Swakopmund Свакопмунд
FYTM => Tsumeb Тсумеб
FYWB => Walvis Bay Волвис-Бей
FYWE => Windhoek Виндхек
FYWH => Hsinchu 
FZAG => Moanda Моанда
FZAJ => Boma Бома
FZAL => Luozi Луози
FZAM => Matadi Матади
FZAR => Nkolo Нколо
FZBA => Inongo Инонго
FZBI => Nioki Ниоки
FZBO => Bandundu Бандунду
FZBT => Kiri Кири
FZCA => Kikwit Киквит
FZCB => Idiofa Идиофа
FZCE => Lusanga Лусанга
FZCV => Masi Manimba Маси-Манимба
FZEA => Mbandaka Мбандака
FZEN => Basankusu Базанкусу
FZFA => Libenge Либенж
FZFD => Gbadolite Гбадолите
FZFK => Gemena 
FZFP => Kota Koli 
FZFU => Bumba Бумба
FZFV => Gorgan 
FZGA => Lisala Лисала
FZGN => Boende Боэнде
FZGV => Ikela Икела
FZIC => Kisangani 
FZIR => Yangambi Янгамби
FZJH => Isiro 
FZKA => Bunia Буниа
FZKJ => Buta 
FZMA => Bukavu 
FZNA => Goma Гома
FZNP => Beni Бени
FZOA => Kindu Кинду
FZOD => Kalima Калима
FZOK => Kasongo Lunda Казонго-Лунда
FZOP => Punia Пуниа
FZQA => Lubumbashi 
FZQC => Pweto Пуэто
FZQG => Kasenga Касенга
FZQM => Kolwezi Колвези
FZRA => Manono Маноно
FZRB => Moba Моба
FZRF => Kalemie Калемие
FZRM => Kabalo Кабало
FZRQ => Kongolo Конголо
FZSA => Kamina Камина
FZSK => Kapanga Капанга
FZTK => Kaniama Каниама
FZUA => Kananga Кананга
FZUG => Luiza Луиза
FZUK => Tshikapa Тшикапа
FZVA => Lodja Лоджа
FZVI => Lusambo Лусамбо
FZVM => Mweka Мвека
FZVR => Basongo Базонго
FZVS => Ilebo Илебо
FZWA => Mbuji Mayi 
FZWC => Gandajika Гандаджика
FZWT => Kabinda Кабинда
GABS => Bamako 
GAGM => Goundam Гундам
GAGO => Gao Гао
GAKA => Kenieba Кеньеба
GAKM => Kelly Bar 
GAKO => Koutiala Кутиала
GAKY => Kayes Кайес
GAMB => Mopti 
GANK => Nara Нара
GANR => Nioro Ниоро
GASG => Segou Сегу
GASK => Sikasso Сикассо
GATB => Tombouctou Томбукту
GAYE => Yelimane Йелиман
GBYD => Banjul 
GCFV => Puerto del Rosario 
GCGM => San Sebas De La Gomera 
GCHI => Valverde Валверде
GCLA => Santa Cruz De La Palma 
GCLP => Las Palmas 
GCRR => Arrecife Арресиф
GCTS => Tenerife Тенерифе
GCXO => Tenerife Тенерифе
GEML => Melilla Мелилья
GFBN => Bonthe Бонте
GFBO => Bo 
GFGK => Gbangbatok Гбангбаток
GFHA => Freetown 
GFKB => Kabala Кабала
GFKE => Kenema Кенема
GFLL => Freetown 
GFYE => Yengema Енгема
GGBU => Bubaque Бубаку
GGOV => Bissau 
GLBU => Buchanan Бучанан
GLCP => Cape Palmas Кейп-Палмас
GLGE => Sinoe Синоу
GLMR => Monrovia 
GLNA => Nimba Нимба
GLRB => Monrovia 
GLST => Sasstown Сасстаун
GLTN => Tchien Тчиен
GLVA => Voinjama Войнджама
GMAD => Agadir Агадир
GMAT => Tan Tan Тан Тан
GMFF => Feira De Santana 
GMFF => Fez Фес
GMFF => White Sulphur Springs 
GMFK => Er-Rachidia 
GMFM => Meknes Мекнес
GMFO => Oujda Уджда
GMMA => Smara Смара
GMMC => Casablanca Касабланка
GMME => Rabat Рабат
GMMF => Sidi Ifni Сиди-Ифни
GMMH => Dakhla 
GMMI => Essaouira Эссаурия
GMML => Laayoune Лаайюн
GMMN => Casablanca Касабланка
GMMN => Mvuu Camp 
GMMS => Safi Сафи
GMMW => Nador Надор
GMMX => Marrakech Марракеш
GMMY => Kenitra Кенитра
GMMZ => Ouarzazate Уазазат
GMTA => Al Hoceima 
GMTN => Tetuan 
GMTT => Tangier Танжер
GODK => Kolda Колда
GOGG => Ziguinchor Зигунчор
GOGS => Cap Skirring Кеп-Скирринг
GOOK => Kaolack Каолак
GOOY => Dakar Дакар
GOSM => Matam Матам
GOSP => Podor Подор
GOSR => Richard Toll Ричард-Толл
GOSS => St Louis Сент Луис
GOTB => Bakel Бакель
GOTK => Kedougou Кедугу
GOTS => Simenti Сименти
GOTT => Tambacounda Тамбакунда
GQNA => Aioun El Atrouss 
GQNB => Boutilimit Бутилимит
GQNC => Tichitt Тишитт
GQND => Tidjikja Тиджикья
GQNE => Boghe Боге
GQNF => Kiffa Киффа
GQNH => Timbedra Тимбедра
GQNI => Nema Нема
GQNJ => Akjoujt Акжужт
GQNK => Kaedi Кеди
GQNL => Moudjeria Мауджерия
GQNN => Nouakchott Нуакшот
GQNS => Selibaby Селибаби
GQNT => Tamchakett Тамшакет
GQNU => Mbout Мбаут
GQPA => Atar Атар
GQPF => Fderik 
GQPP => Nouadhibou Нуакдибу
GQPP => Ndalatandos 
GQPZ => Zouerate Зурате
GQPZ => Richmond Ричмонд
GUCY => Conakry 
GUFA => Fria Фриа
GUFH => Faranah Фаранах
GUKU => Kissidougou Киссидугу
GULB => Labe Лабе
GUMA => Macenta Масента
GUNZ => Nzerekore 
GUOK => Boke Боке
GUSB => Koundara Кундара
GUSI => Siguiri Сигуири
GUXD => Kankan Канкан
GVAC => Sal 
GVAN => Santo Antao Санто-Антао
GVAN => Solomon 
GVBA => Boa Vista 
GVBR => Brava 
GVMA => Maio 
GVMT => Mosteiros Мостейрос
GVNP => Praia 
GVSF => Parsabad 
GVSF => Sao Filipe 
GVSN => Sao Nicolau 
GVSV => Sao Vicente 
HAAB => Addis Ababa Аддис Абеба
HAAM => Arba Mintch Арба-Минч
HAAW => Awareh Аварех
HAAX => Axum Аксум
HABB => Buno Bedelle Буно-Беделле
HABC => Jinka 
HABD => Bahar Dar Бахар-Дар
HABE => Beica Бейка
HABU => Bulchi Бульчи
HADB => Degahbur Дегабур
HADC => Dessie Десси
HADD => Dembidollo Дембидолло
HADM => Debra Marcos Дебра-Маркос
HADR => Dire Dawa 
HADT => Debra Tabor Дебра-Табор
HAFN => Fincha Финча
HAGB => Goba Гоба
HAGH => Ghinnir Гиннир
HAGL => Geladi Гелади
HAGM => Gambela Гамбела
HAGN => Gondar Гондэр
HAGO => Gode/Iddidole 
HAGR => Gore Гор
HAHU => Humera Хумера
HAJJ => Jijiga Джиджига
HAJM => Jimma Джимма
HAKD => Kabri Dar Кабри-Дар
HAKL => Kelafo/Callaf 
HALA => Awassa Авасса
HALL => Lalibela 
HAMA => Mekane Selam 
HAMK => Makale Макале
HAMM => Chagni 
HAMN => Mendi Менди
HAMR => Mui Муи
HAMT => Mizan Teferi Мизан-Тефери
HANG => Neghelli Негелли
HANJ => Nejjo 
HANK => Nekemt 
HAPW => Pawi 
HASD => Soddu Содду
HASK => Shakiso Шакисо
HASL => Shillavo Шилаво
HASO => Asosa Асоса
HATP => Tippi Типпи
HAWC => Waca Вака
HAWR => Warder Уордер
HBBA => Bujumbura 
HBBE => Gitega 
HBBO => Kirundo 
HCMA => Alula Алула
HCMB => Baidoa Байдоа
HCMC => Candala Кандала
HCMD => Bardera Бардера
HCME => Eil 
HCME => Ilaam 
HCMF => Bossaso Боссасо
HCMG => Garoe 
HCMG => Gardo Гардо
HCMH => Hargeisa Харгейса
HCMI => Berbera Бербера
HCMJ => Lugh Ganane Лю-Ганан
HCMK => Kismayu Кисмайо
HCMM => Mogadishu 
HCMO => Obbia Оббиа
HCMR => Galcaio Галкайо
HCMS => Scusciuban Скускубан
HCMU => Erigavo Эригаво
HCMV => Burao Бурао
HDAM => Djibouti Джибути
HDAS => Alisabieh 
HDMO => Musha Муша
HDOB => Obock Обок
HDTJ => Tadjoura Таджура
HEAR => Al Arish Аль-Ариш
HEAT => Assiut Асьют
HEAX => Alexandria Александрия
HEBA => Whitesburg 
HEBA => Alexandria Александрия
HEBL => Abu Simbel Абу-Симбель
HECA => Cairo Каир
HEDK => Dakhla Oasis 
HEGN => Hurghada Хургада
HEKG => Kharga 
HELX => Luxor Луксор
HEMA => Marsa Alam 
HEMM => Mersa Matruh 
HEMN => El Minya Эль-Минья
HEOW => Shark Elowainat 
HEPS => Port Said Порт-Саид
HESC => Santa Katarina Санта-Катарина
HESH => Manguna 
HESH => Sharm El Sheikh Шарм Эль Шейх
HESN => Aswan Асуан
HETB => Nichen Cove, AK 
HETB => Taba Таба
HETR => Tour Sinai City Тур-Синай-Сити
HHAS => Asmara 
HHAS => Hesa 
HHAS => Ivishak 
HHMS => Massawa Массава
HHSB => Assab Ассаб
HHTS => Tessenei Тессеней
HKAM => Amboseli Амбосели
HKEL => Eldoret Элдорет
HKES => Eliye Springs Элийе-Спрингс
HKFG => Kalokol Калокол
HKGA => Garissa Гарисса
HKHO => Hola Хола
HKJK => Nairobi Найроби
HKKI => Kisumu Кисуму
HKKL => Kilaguni Килагуни
HKKR => Kericho Керичо
HKKT => Kitale Китале
HKLO => Lodwar Лодвар
HKLU => Lamu 
HKLY => Loyangalani 
HKMA => Mandera Мандера
HKMB => Marsabit Марсабит
HKML => Malindi Малинди
HKMO => Mombasa Момбаса
HKMY => Moyale Мояль
HKNI => Nyeri Ньери
HKNK => Nakuru Накуру
HKNW => Nairobi Найроби
HKNY => Nanyuki Нануки
HKSB => Samburu Самбуру
HKWJ => Wajir Ваджир
HLGD => Sert Серт
HLGN => Tobruk Тобрук
HLGT => Ghat Гат
HLKF => Kufrah Куфра
HLLB => Benghazi 
HLLM => Mitiga 
HLLQ => Brack Вейл-Игл, шт. Колорадо
HLLQ => Beida Бейда
HLLS => Sebha Себа
HLLT => Tripoli Триполи
HLMB => Marsa Brega Марса-Брега
HLON => Houn Хоун
HLTD => Ghadames Гадамес
HLZW => Zwara 
HLZW => Kota Kinabalu Кота Кинабалу
HRYG => Gisenyi Гисеный
HRYI => Butare Бутаре
HRYR => Chkalovsky Чкаловский
HRYR => Kigali 
HRYU => Ruhengeri Руэнгери
HRZA => Kamembe Камембе
HSAT => Atbara Атбара
HSDB => Eldebba 
HSDN => Dongola Донгола
HSFS => El Fasher Эль-Фашер
HSGF => Gedaref Гедарев
HSGG => Dinder Диндер
HSGN => Geneina 
HSKA => Kassala Кассала
HSKG => Khashm El Girba 
HSKI => Kosti Кости
HSMR => Merowe Мерове
HSNH => En Nahud Эн-Нахуд
HSNN => Nyala Ньяла
HSNW => New Halfa Нью-Халфа
HSOB => El Obeid Эль-Обейд
HSPN => Port Sudan Порт-Судан
HSSJ => Juba Джуба
HSSM => Malakal Малакал
HSSS => Khartoum Хартум
HSSW => Wadi Halfa Вади-Халфа
HSWD => Wad Medani Вад-Медани
HSWW => Wau Вау
HTAR => Arusha Аруша
HTBU => Bukoba Букоба
HTDA => Amook 
HTDA => Dar Es Salaam 
HTDA => Riesa 
HTDO => Dodoma Додома
HTIR => Iringa Иринга
HTKA => Kigoma Кигома
HTKI => Kilwa Килва
HTKJ => Kilimanjaro Килиманджаро
HTLI => Lindi Линди
HTLM => Lake Manyara Лейк-Маньяра
HTMA => Mafia 
HTMB => Mbeya Мбея
HTMD => Mwadui Мвадуй
HTMI => Masasi Масаси
HTMT => Mtwara Мтвара
HTMU => Musoma Мусома
HTMW => Mwanza Мванза
HTNA => Nachingwea Начингвеа
HTNJ => Njombe Ньомбе
HTPE => Pemba 
HTSN => Seronera Серонера
HTSO => Songea Сонгеа
HTSU => Sumbawanga Сумбаванга
HTSY => Shinyanga Шиньянга
HTTB => Tabora Табора
HTTG => Tanga Танга
HTZA => Zanzibar 
HUAR => Arua Аруа
HUEN => Entebbe 
HUGU => Gulu Гулу
HUJI => Jinja Джинджа
HUKF => Kabalega Falls 
HUKS => Kasese Касесе
HUMA => Mbarara Мбарара
HUMI => Masindi Масинди
HUPA => Pakuba Пакуба
HUSO => Soroti Сороти
HUTO => Tororo Тороро
KAAF => Apalachicola 
KAAP => Houston, TX 
KABI => Abilene 
KABQ => Albuquerque Альбукерк
KABR => Aberdeen 
KABY => Albany Олбани
KACB => Bellaire 
KACJ => Anuradhapura Анурадхапура
KACK => Nantucket 
KACT => Waco Вако
KACV => Arcata 
KACY => Atlantic City Атлантик Сити
KADC => Andakombe 
KADG => Adrian 
KADH => Ada Ада
KADM => Ardmore Ардмор
KADS => Dallas Даллас
KADW => Camp Springs 
KAEL => Albert Lea Альберт Ли
KAEX => Alexandria, LA 
KAFF => Colorado Springs Колорадо Спрингз
KAFJ => Washington 
KAFK => Ampara 
KAFN => Jaffrey 
KAFO => Afton Афтон
KAFW => Fort Worth, TX 
KAGC => Pittsburgh Питтсборо
KAGO => Magnolia 
KAGS => Augusta 
KAHC => Herlong 
KAHD => Ardmore Ардмор
KAHH => Amery 
KAHN => Athens Афины
KAHQ => Woodchopper 
KAIA => Alliance 
KAID => Anderson 
KAIK => Aiken 
KAIO => Atlantic 
KAIV => Aliceville 
KAIY => Atlantic City Атлантик Сити
KAIZ => Kaiser/Lake Ozark 
KAKO => Akron, CO Akron
KAKR => Akron/Canton 
KALB => Albany Олбани
KALI => Alice 
KALM => Alamogordo Аламогордо
KALN => Alton 
KALO => Waterloo Ватерло
KALS => Alamosa Аламоса
KALW => Walla Walla 
KALX => Alexander City 
KALZ => Alitak 
KAMA => Amarillo, TX 
KAMN => Alma 
KAMW => Ames 
KANA => Anaheim Анахайм
KANB => Anniston 
KAND => Anderson 
KANK => Salida 
KANP => Annapolis Аннаполис
KANQ => Angola Ангола
KANW => Ainsworth 
KANY => Anthony 
KAOH => Lima Лима
KAOO => Martinsburg 
KAPA => Denver Денвер
KAPC => Napa Напа
KAPF => Naples Неаполь
KAPG => Aberdeen 
KAPH => Bowling Green 
KAPN => Alpena 
KAPT => Jasper Джаспер
KAPV => Apple Valley Эппл Вэлли
KAPY => Jiang Men 
KAQY => Alyeska 
KARA => New Iberia 
KARB => Ann Arbor, MI 
KARG => Walnut Ridge 
KARM => Wharton 
KARR => Aurora 
KART => Watertown 
KARV => Minocqua 
KARW => Beaufort 
KASE => Aspen Аспен
KASG => Springdale 
KASH => Nashua, NH 
KASL => Marshall Маршалл
KASN => Talladega Талладега
KASQ => Austin Остин
KAST => Astoria 
KASX => Ashland Эшленд
KASY => Ashley 
KATE => Antlers 
KATL => Atlanta, GA 
KATS => Artesia 
KATW => Appleton Эпплтон
KATY => Watertown 
KAUG => Augusta 
KAUM => Austin Остин
KAUN => Auburn Обурн
KAUO => Auburn Обурн
KAUW => Wausau 
KAVL => Fletcher 
KAVO => Avon Park 
KAVP => Wilkes-Barre/Scranton, PA 
KAVQ => Tucson Туксон
KAVX => Catalina Island 
KAVX => Catalina Island 
KAWM => West Memphis 
KAXA => Algona 
KAXB => Alexandria Bay 
KAXN => Alexandria Александрия
KAXS => Altus 
KAXV => Wapakoneta 
KAXX => Angel Fire 
KAYS => Waycross 
KAYS => Ankorefo 
KAZO => Kalamazoo Каламазу
KAZO => Port Armstrong Порт Армстронг
KBAB => Marysville 
KBAD => Shreveport Шревспорт
KBAF => Westfield 
KBAK => Columbus 
KBAM => Battle Mountain 
KBAX => Xanxere 
KBBB => Benson 
KBBD => Brady 
KBBP => Bennettsville 
KBBW => Broken Bow 
KBCB => Blacksburg 
KBCC => Bear Creek 
KBCE => Bryce 
KBCT => Boca Raton Бока Ратон
KBCT => Redang 
KBDE => Baudette 
KBDF => Bradford 
KBDG => Blanding 
KBDL => Windsor Locks 
KBDL => Lakeside 
KBDR => Bridgeport 
KBDU => Boulder 
KBDX => Broadus 
KBDY => Bandon 
KBEC => Wichita Вичита
KBED => Bedford/Hanscom 
KBEH => Benton Harbor Бентон Харбор
KBFA => Bahia Negra 
KBFD => Bradford 
KBFF => Scottsbluff 
KBFG => Bullfrog Basin 
KBFI => Seattle Сиэттл
KBFK => Buffalo 
KBFL => Bakersfield Бейкерсфилд
KBFM => Mobile Мобайл
KBFR => Bedford 
KBFW => Sidi Belabbes 
KBGD => Borger 
KBGE => Bainbridge 
KBGM => Binghamton, NY 
KBGR => Bangor Бангор
KBGS => Big Spring 
KBGT => Bagdad 
KBHB => Bar Harbor Бар Харбор
KBHC => Bhurban 
KBHM => Birmingham 
KBID => Block Island 
KBIE => Beatrice 
KBIF => El Paso Эль Пасо
KBIH => Bishop Бишоп
KBIJ => Biliau 
KBIL => Billings Биллингс
KBIS => Bismarck Бисмарк
KBIX => Biloxi 
KBJC => Broomfield 
KBJI => Bemidji 
KBJJ => Wooster Вустер
KBKD => Breckenridge 
KBKE => Baker 
KBKF => Katmai National Park 
KBKL => Cleveland 
KBKT => Blackstone 
KBKW => Beckley 
KBKX => Brookings 
KBLD => Boulder City 
KBLF => Princeton 
KBLH => Blythe 
KBLI => Bellingham 
KBLM => Belmar - Farmingdale 
KBLU => Blue Canyon 
KBLV => Belleville Белльвиль
KBMC => Brigham City 
KBMG => Bloomington 
KBMI => Bloomington/Normal, IL 
KBML => Berlin Берлин
KBMT => Beaumont 
KBNA => Nashville, TN 
KBNF => Baranof 
KBNG => Banning 
KBNL => Barnwell, SC 
KBNO => Burns 
KBNW => Boone 
KBOF => Washington 
KBOI => Boise, ID 
KBOI => Yerington 
KBOK => Brookings 
KBOS => Boston Бостон
KBOS => Oslo Осло
KBOW => Bartow 
KBPI => Big Piney 
KBPK => Biangabip 
KBPK => Mountain Home 
KBPP => Bowman 
KBPT => Beaumont 
KBQK => Brunswick 
KBQV => Gustavus 
KBRD => Brainerd, MN 
KBRL => Burlington 
KBRO => Brownsville 
KBRY => Bardstown, KY 
KBSQ => Bisbee 
KBSW => Boswell Bay 
KBTF => Bountiful 
KBTL => Battle Creek 
KBTM => Butte, (MT) 
KBTN => Britton 
KBTP => Butler 
KBTR => Baton Rouge Батон Руж
KBTV => Burlington 
KBTY => Beatty 
KBUB => Burwell 
KBUF => San Carlos Сан Карлос
KBUM => Butler 
KBUR => Blue Fox Bay 
KBUR => Curitiba Куритиба
KBUR => Burbank Бурбанк
KBUR => Pope Vanoy 
KBVI => Beaver Falls 
KBVO => Bartlesville 
KBVS => Mount Vernon 
KBVX => Batesville 
KBVY => Beverly 
KBWC => Brawley 
KBWD => Brownwood 
KBWG => Bowling Green 
KBWI => Baltimore/Washington 
KBWL => Blackwell 
KBWP => Wahpeton 
KBWS => Blaine 
KBXA => Bogalusa 
KBXG => Bendigo Бендиго
KBXK => Buckeye 
KBXS => Borrego Springs 
KBYA => Boundary 
KBYG => Buffalo 
KBYH => Blytheville 
KBYI => Rupert 
KBYS => Fort Irwin 
KBYW => Blakely Island 
KBYY => Bay City Бэй Сити
KBZN => Bozeman 
KBZS => Washington 
KCAD => Cadillac 
KCAE => Columbia, SC 
KCAG => Craig 
KCAK => Akron/Canton, OH 
KCAO => Clayton 
KCAR => Caribou 
KCBE => Cumberland 
KCBF => Council Bluffs 
KCBK => Colby 
KCBM => Columbus 
KCCA => Fort Chaffee 
KCCB => Upland, CA 
KCCG => Crane 
KCCR => Concord 
KCCY => Charles City 
KCDA => Lyndonville 
KCDC => Cedar City Сидар Сити
KCDH => Camden 
KCDI => Cachoeiro Itapemirim 
KCDK => Cedar Key 
KCDL => Candle 
KCDN => Camden 
KCDR => Chadron 
KCDS => Childress Чайлдресс
KCDW => Caldwell, NJ 
KCEA => Wichita Вичита
KCEC => Crescent City 
KCEF => Springfield 
KCEU => Clemson 
KCEV => Connersville 
KCEW => Crestview 
KCEW => San Ignacio Сан-Игнасио
KCEX => Chena Hot Springs 
KCEY => Murray 
KCEY => Key Largo Ки Ларго
KCEZ => Cortez Кортез
KCFD => Bryan 
KCFT => Clifton 
KCFV => Coffeyville 
KCGA => Craig 
KCGE => Cambridge Кембрдидж
KCGF => Cleveland 
KCGI => Cape Girardeau 
KCGS => College Park Колледж парк
KCGZ => Casa Grande 
KCHA => Chattanooga,TN 
KCHD => Mesa Меса
KCHI => Chicago Чикаго
KCHK => Chickasha 
KCHO => Charlottesville Шарлоттсвилль
KCHP => Circle Hot Springs 
KCHS => Charleston, SC 
KCHZ => Chiloquin 
KCIC => Chico 
KCID => Abbottabad 
KCID => Algeciras Альгесирас
KCID => Aiambak 
KCID => Ai-ais 
KCID => Eskisehir Эскишехир
KCID => Cedar Rapids 
KCIL => Council 
KCIN => Carroll 
KCIR => Cairo Каир
KCIU => Campo Mourao 
KCIU => Sault Ste Marie Со Сен Мари
KCIU => Cape Orford 
KCIU => Pittsburgh Питтсборо
KCJN => San Diego/El Cajon, CA 
KCKA => Cherokee Чероки
KCKB => Clarksburg 
KCKC => Grand Marais 
KCKE => Clear Lake 
KCKM => Clarksdale 
KCKN => Crookston 
KCKU => Cordova 
KCKV => Clarksville Кларксвилл
KCKX => Chicken 
KCLE => Cleveland 
KCLG => Coalinga 
KCLI => Clintonville 
KCLK => Clinton 
KCLL => College Station, TX 
KCLM => Port Angeles Порт Анжелес
KCLR => Calipatria 
KCLS => Chehalis 
KCLT => Charlotte Шарлотт
KCLW => Clearwater Клируотер
KCMH => Columbus 
KCMH => Point Retreat 
KCMI => Champaign 
KCMX => Hancock Хэнкок
KCMX => Khatgal 
KCMY => Sparta Спарта
KCNH => Claremont 
KCNK => Concordia 
KCNM => Carlsbad 
KCNO => Chino 
KCNU => Chanute 
KCNW => Waco, TX 
KCNY => Moab Моаб
KCOA => Columbia Колумбия
KCOD => Cody/Yellowstone 
KCOD => Mahaweli 
KCOF => Cocoa 
KCOI => Cocoa 
KCOM => Coleman 
KCON => Concord 
KCOP => Cooperstown, NY 
KCOS => Colorado Springs Колорадо Спрингз
KCOT => Cotulla 
KCOU => Columbia Колумбия
KCPM => Compton 
KCPR => Casper 
KCPS => St Louis, Il 
KCQA => Canarana 
KCQW => Cheraw 
KCRE => Myrtle Beach Миртл Бич
KCRG => Jacksonville 
KCRO => Corcoran 
KCRP => Corpus Christi, TX 
KCRQ => Carlsbad, CA 
KCRS => Corsicana 
KCRT => Crossett 
KCRW => Charleston 
KCRX => Corinth Коринт
KCSE => Crested Butte 
KCSM => Clinton 
KCSQ => Creston 
KCSV => Crossville 
KCTB => Cut Bank 
KCTK => Canton 
KCTO => Calverton 
KCTW => Cottonwood 
KCTX => Cortland 
KCTY => Cross City 
KCTZ => Clinton 
KCUB => Columbia Колумбия
KCUH => Cushing 
KCUX => Corpus Christi Корпус Кристи
KCVG => Covington, KY 
KCVH => Hollister 
KCVN => Clovis 
KCVO => Albany Олбани
KCVS => Clovis 
KCWA => Wausau 
KCWC => Wichita Falls 
KCWI => Clinton 
KCWO => Mineral Wells 
KCWS => Center Island 
KCXC => Chitina 
KCXL => Calexico 
KCXO => Conroe 
KCXP => Carson City 
KCXY => Harrisburg 
KCYM => Chatham 
KCYS => Cheyenne Чейнни
KCZC => Copper Centre 
KCZK => Cascade Locks 
KCZN => Chisana 
KCZO => Chistochina 
KCZP => Cape Pole 
KCZT => Carrizo Springs 
KDAA => Fort Belvoir 
KDAB => Daytona Beach Дайтона Бич
KDAG => Daggett 
KDAL => Dallas Даллас
KDAN => Danville 
KDAY => Dayton, Oh 
KDAY => Monteagudo 
KDAY => Mouscron 
KDAY => Marble Canyon 
KDBN => Dublin Дублин
KDBQ => Dubuque Дюбюк
KDBS => Dubois 
KDCA => Washington, DC 
KDCK => Dahl Creek 
KDCR => Decatur 
KDCU => Decatur 
KDDC => Dodge City 
KDEC => Decatur 
KDEH => Decorah 
KDEN => Denver Денвер
KDET => Detroit Детройт
KDFI => Defiance 
KDFW => Dallas, TX 
KDGL => Douglas 
KDGW => Douglas 
KDHN => Dothan 
KDHT => Dalhart 
KDIK => Dickinson 
KDIO => Diomede Island 
KDJN => Delta Junction 
KDKK => Dunkirk 
KDLC => Dillon 
KDLF => Del Rio Дель Рио
KDLH => Duluth 
KDLN => Dillon 
KDLS => The Dalles 
KDMA => Tucson Туксон
KDMN => Deming 
KDMO => Sedalia 
KDNE => Dallas Даллас
KDNL => Augusta, GA 
KDNN => Dalton 
KDNS => Denison 
KDNV => Danville, IL 
KDOV => Dover-Cheswold 
KDPA => Chicago Чикаго
KDPA => Deer Park 
KDPG => Dugway 
KDRA => Mercury 
KDRI => De Ridder 
KDRM => Drummond Island 
KDRM => Drama Драма
KDRO => Durango Дуранго
KDRT => Del Rio Дель Рио
KDSM => Des Moines, IA 
KDSV => Dansville 
KDTA => Delta 
KDTL => Detroit Lakes 
KDTN => Shreveport, LA 
KDTS => Destin Дестин
KDTW => Detroit, MI 
KDUA => Durant 
KDUC => Duncan 
KDUF => Corolla, NC 
KDUG => Douglas 
KDUJ => Du Bois 
KDVK => Diavik 
KDVL => Devils Lake 
KDVN => Davenport 
KDVO => Novato 
KDVT => Phoenix Феникс
KDWH => Houston Хьюстон
KDWN => Oklahoma City Оклахома Сити
KDXR => Danbury, CT 
KDXX => Port Oceanic 
KDXX => Husum 
KDXX => Cannes Канны
KDYL => Doylestown 
KDYS => Abilene 
KEAN => Wheatland 
KEAR => Kearney 
KEAT => Wenatchee 
KEAU => Corner Bay 
KEAU => Eau Claire, WI 
KEBS => Webster City 
KECA => East Tawas 
KECG => Elizabeth City, NC 
KECS => Newcastle Ньюкасл
KEDA => Edna Bay 
KEDE => Edenton 
KEDG => Edgewood 
KEDN => Enterprise 
KEDW => Edwards AFB 
KEED => Needles 
KEEN => Keene 
KEFD => Houston Хьюстон
KEFK => Newport 
KEFO => East Fork 
KEFW => Jefferson 
KEGE => Vail/Eagle 
KEGI => Valparaiso Вальпараисо
KEGP => Eagle Pass 
KEGV => Eagle River 
KEKA => Eureka, CA 
KEKM => Elkhart 
KEKN => Elkins 
KEKO => Elko, NV 
KEKX => Elizabethtown 
KELA => Eagle Lake 
KELD => El Dorado Эль-Дорадо
KELK => Elk City 
KELK => El Tigre 
KELM => Corning, NY 
KELN => Ellensburg 
KELO => Ely 
KELP => Kwajalein Atoll 
KELP => El Paso Эль Пасо
KELW => Ellamar 
KELY => Ely 
KELZ => Wellsville 
KEMB => San Francisco Сан-Кристобаль
KEMM => Kemerer 
KEMP => Emporia 
KEMT => El Monte 
KEND => Enid 
KENL => Centralia 
KENV => Wendover 
KENW => Kenosha 
KEOK => Keokuk 
KEOS => Neosho 
KEPG => Weeping Water 
KEPH => Ephrata 
KEQA => El Dorado Эль-Дорадо
KERI => Erie Эри
KERR => Errol 
KERV => Kerrville 
KESC => Escanaba 
KESF => Alexandria Александрия
KESN => Easton 
KESP => East Stroudsburg 
KEST => Estherville 
KESW => Easton 
KETB => West Bend 
KETN => Eastland 
KEUE => Eureka 
KEUF => Eufaula 
KEUG => Eugene Юджин
KEVA => Evadale 
KEVM => Eveleth 
KEVV => Evansville, IN 
KEVW => Evanston 
KEWB => New Bedford 
KEWK => Newton Ньютон
KEWN => New Bern Нью Берн
KEWR => Newark 
KEXI => Excursion Inlet 
KEYW => Key West Ки Уэст
KFAF => Fort Eustis 
KFAK => False Island 
KFAM => Farmington 
KFAR => Fargo Фарго
KFAT => Fresno Фресно
KFAY => Fayetteville Файетвилл
KFBG => Fort Bragg 
KFBL => Faribault 
KFBR => Fort Bridger 
KFBY => Fairbury 
KFCH => Fresno Фресно
KFCM => Minneapolis Миннеаполис
KFCS => Colorado Springs Колорадо Спрингз
KFCT => Yakima Якима
KFCY => Forrest City 
KFDK => Frederick 
KFDR => Frederick 
KFDY => Findlay 
KFEP => Freeport 
KFES => San Fernando Сан Фернандо
KFET => Fremont 
KFEW => Cheyenne Чейнни
KFFA => Kill Devil Hills 
KFFL => Fairfield 
KFFM => Fergus Falls 
KFFO => Dayton 
KFFT => Frankfort, KY 
KFFZ => Mesa Меса
KFHR => Friday Harbor 
KFHU => Sierra Vista 
KFID => Fishers Island 
KFKL => Franklin 
KFKN => Franklin 
KFLD => Fond Du Lac 
KFLE => Petersburg Петерсбург
KFLG => Grand Canyon 
KFLL => Fort Lauderdale Форт Лодердейл
KFLO => Florence Флоренция
KFLP => Flippin 
KFLT => Flat 
KFLU => New York Нью-Йорк
KFLV => Fort Leavenworth 
KFLX => Fallon 
KFME => Fort Meade 
KFMH => Falmouth Фолмаут
KFMN => Farmington 
KFMY => Fort Myers Форт Майерс
KFNL => Fort Collins/Loveland 
KFNT => Flint Флинт
KFOB => Fort Bragg 
KFOD => Fort Dodge, IA 
KFOE => Topeka, KS 
KFOE => Tarabo Тарабо
KFOE => Taabo 
KFOE => Tupai 
KFOK => Westhampton 
KFOM => Fillmore 
KFOP => Forest Park Форест Парк
KFPR => Fort Pierce 
KFPY => Perry 
KFRG => Farmingdale 
KFRH => French Lick 
KFRH => Long Island Лонг Айленд
KFRI => Fort Riley, KS 
KFRM => Fairmont 
KFRP => Fresh Water Bay 
KFRR => Front Royal, (VA) 
KFSD => Fire Cove 
KFSD => Sioux Falls 
KFSD => Cambridge Кембрдидж
KFSI => Fort Sill 
KFSK => Fort Scott 
KFSM => Fort Smith 
KFSN => Fort Sheridan 
KFST => Fort Stockton 
KFSU => Fort Sumner 
KFSW => Fort Madison 
KFTK => Fort Knox 
KFTW => Fort Worth Форт Уорт
KFTY => Atlanta Атланта
KFUL => Fullerton 
KFVE => Frenchville 
KFWA => Fort Wayne Форт Уэйн
KFXE => Fort Lauderdale Форт Лодердейл
KFXY => Forest City 
KFYM => Fayetteville Файетвилл
KFYV => Fayetteville Файетвилл
KGAB => Gabbs 
KGAD => Gadsden 
KGAG => Gage 
KGAG => Gakona 
KGAI => Gaithersburg 
KGAZ => Guasopa 
KGBD => Great Bend 
KGBG => Galesburg 
KGBN => San Giovanni Rotondo Сан Джованни Ротондо
KGBO => Baltimore Балтимор
KGBR => Great Barrington 
KGCC => Gillette Жилетте
KGCD => John Day 
KGCK => Garden City, KS 
KGCN => Grand Canyon 
KGCY => Greenville 
KGDH => Golden Horn Lodge, Alaska 
KGDM => Gardner 
KGDV => Glendive 
KGDW => Gladwin 
KGED => Georgetown 
KGEG => Spokane Спокане
KGEY => Greybull 
KGFA => Great Falls 
KGFD => Greenfield 
KGFK => Grand Forks 
KGFL => Glens Falls 
KGGE => Georgetown 
KGGG => Kilgore 
KGGG => Ticantiki 
KGGW => Glasgow 
KGHM => Centerville 
KGIF => Winter Haven 
KGJT => Grand Junction Гранд Джанкшн
KGKJ => Meadville 
KGKT => Gatlinburg Гатлинбург
KGLD => Goodland 
KGLE => Gainesville 
KGLH => Greenville 
KGLR => Gaylord 
KGLS => Galveston Гелвстон
KGLW => Glasgow 
KGMT => Granite Mountain 
KGMU => Greenville 
KGNG => Gooding 
KGNT => Grants 
KGNU => Goodnews Bay 
KGNV => Gainesville 
KGOF => San Angelo 
KGOK => Guthrie 
KGOL => Gold Beach 
KGON => New London 
KGPI => Kalispell, MT 
KGPT => Gulfport 
KGPZ => Grand Rapids 
KGQQ => Galion 
KGRB => Green Bay Грин Бэй
KGRD => Greenwood 
KGRE => Greenville 
KGRF => Tacoma Такома
KGRI => Grand Island, NE 
KGRK => Fort Hood, TX 
KGRN => Gordon 
KGRR => Grand Rapids 
KGSB => Goldsboro 
KGSH => Goshen 
KGSO => High Point 
KGSP => Greenville 
KGTF => Great Falls 
KGTG => Grantsburg 
KGTR => Columbus 
KGTY => Gettysburg Геттисберг
KGUC => Gunnison 
KGUN => Montgomery 
KGUP => Gallup Галлап
KGUS => Peru, Indiana 
KGUY => Guymon 
KGVE => Gordonsville 
KGVL => Gainesville 
KGVT => Greenville 
KGWO => Greenwood 
KGWS => Glenwood Springs 
KGWV => Glendale 
KGXY => Greeley 
KGYH => Greenville 
KGYI => Sherman-Denison 
KGYR => Goodyear 
KGYY => Gary (IN) 
KHAB => Hamilton Гамильтон
KHAE => Havasupai 
KHAF => Half Moon 
KHAI => Three Rivers 
KHAO => Hamilton Гамильтон
KHAX => Muskogee 
KHAY => Haycock 
KHBB => Hobbs 
KHBG => Burlington 
KHBG => Hattiesburg Хаттисберг
KHBG => Peppers Palm Bay 
KHBH => Hobart Bay 
KHBI => Harbour Island Харбор-Айленд
KHBR => Hobart, OK 
KHCA => Big Spring 
KHCB => Shoal Cove 
KHDE => Holdrege 
KHDN => Hayden 
KHDN => Corner Brook 
KHDN => Natuashish 
KHED => Herendeen 
KHEE => Helena Хелена
KHEF => Manassas Манассас
KHEY => Ozark 
KHEZ => Natchez Натчез
KHFD => Hartford Хартфорд
KHFF => Hoffman 
KHGR => Hagerstown 
KHGT => Jolon 
KHGZ => Hogatza 
KHHR => Hawthorne 
KHHW => Hugo 
KHIB => Chisholm 
KHIE => Whitefield 
KHIF => Ogden Огден
KHII => Hanus Bay 
KHII => Lake Havasu City 
KHIO => Hillsboro 
KHKA => Blytheville 
KHKS => Jackson Джексон
KHKY => Hickory 
KHLB => Batesville 
KHLC => Hill City 
KHLG => Wheeling 
KHLM => Holland 
KHLN => Helena Хелена
KHLR => Killeen 
KHLX => Glennallen 
KHMN => Alamogordo Аламогордо
KHMS => Homeshore AK 
KHMT => Hemet 
KHNB => Huntingburg 
KHND => Las Vegas Лас Вегас
KHOB => Hobbs 
KHON => Huron 
KHOP => Hopkinsville 
KHOT => Hot Springs 
KHOU => Humboldt 
KHOU => Houston, TX 
KHPN => White Plains 
KHPT => Hampton 
KHPY => Baytown 
KHQM => Hoquiam 
KHRI => Hermiston 
KHRL => Harlingen Харлинген
KHRO => Harrison 
KHSB => Harrisburg 
KHSE => Hatteras 
KHSI => Hastings 
KHSP => Hot Springs 
KHST => Homestead 
KHSV => Huntsville 
KHTH => Hawthorne 
KHTL => Houghton 
KHTO => East Hampton 
KHTS => Huntington 
KHTW => Chesapeake/Huntington Wv 
KHUA => Huntsville 
KHUF => Terre Haute 
KHUK => Hukuntsi 
KHUL => Houlton 
KHUM => Houma 
KHUT => Hutchinson 
KHVE => Hanksville 
KHVN => New Haven 
KHVR => Havre 
KHVS => Hartsville 
KHWD => Hayward 
KHWI => Hawk Inlet 
KHWO => Hollywood Холливуд
KHWV => Shirley 
KHXD => Hilton Head 
KHYA => Hyannis Хианнис
KHYL => Hollis 
KHYR => Hayward 
KHYS => Hays 
KHZL => Hazleton 
KHZY => Jefferson 
KIAB => Wichita Вичита
KIAD => Washington, DC 
KIAG => Niagara Falls Ниагара Фоллз
KIAH => Bartletts 
KIAH => Houston Хьюстон
KICL => Clarinda 
KICT => Wichita Вичита
KICY => Icy Bay 
KIDA => Idaho Falls Айдахо Фоллз
KIDG => Ida Grove 
KIDI => Indiana, PA 
KIDP => Independence Индепенденс
KIEN => Pine Ridge 
KIFA => Iowa Falls 
KIFP => Bullhead City 
KIGM => Kingman 
KIJX => Jacksonville 
KIKK => Kankakee 
KILE => Killeen 
KILG => Wilmington 
KILL => Willmar 
KILM => Wilmington 
KILN => Wilmington 
KIML => Imperial 
KIMM => Immokalee 
KIMS => Madison 
KIMT => Iron Mountain 
KIND => Indianapolis, IN 
KINK => Wink 
KINL => International Falls 
KINS => Indian Springs 
KINT => Winston Salem 
KINW => Winslow, AZ 
KIOW => Iowa City, IA 
KIPL => Imperial 
KIPT => Williamsport 
KIRK => Kirksville 
KIRS => Sturgis 
KISM => Kissimmee Киссимми
KISN => Williston 
KISO => Kinston 
KISP => Islip, NY 
KISQ => Manistique 
KISW => Wisconsin Rapids 
KITH => Ithaca 
KITR => Itumbiara 
KIWD => Ironwood 
KIWI => Wiscasset 
KIWS => Houston Хьюстон
KIXD => Olathe, KS 
KIYK => Inyokern 
KIZA => Santa Ynez 
KIZG => Fryeburg 
KJAC => Holikachu 
KJAC => Jackson Джексон
KJAE => Atlanta Атланта
KJAJ => Atlanta Атланта
KJAN => Jackson Джексон
KJAO => Atlanta Атланта
KJAS => Jasper Джаспер
KJAX => Jacksonville, FL 
KJBR => Jonesboro 
KJCT => Junction 
KJCY => Johnson 
KJDN => Jordan Иордания
KJDY => Downey 
KJEF => Jefferson City 
KJFK => New York Нью-Йорк
KJFK => Schaumburg 
KJFK => Mankato 
KJFK => Dallas Даллас
KJHW => Jamestown Джеймстаун
KJKA => Gulf Shores 
KJLA => Cooper Lodge 
KJLB => Long Beach 
KJLN => Joplin, MO 
KJLX => Los Angeles Лос Анджелес
KJMC => Sausalito, CA 
KJMS => Jamestown Джеймстаун
KJOT => Joliet 
KJPD => Pasadena 
KJPN => Washington 
KJRA => New York Нью-Йорк
KJRB => New York, NY 
KJSD => Stratford, CT 
KJSO => Jacksonville, TX 
KJSO => Sodertalje Содерталье
KJST => Johnstown 
KJUC => Los Angeles Лос Анджелес
KJVI => Manville 
KJVL => Janesville 
KJWC => Los Angeles Лос Анджелес
KJWN => Zanjan 
KJXN => Jackson Джексон
KJYR => Jiroft 
KKBE => Bell Island 
KKBW => Chignik 
KKCC => Coffman Cove 
KKCK => Kansas City Канзас Сити
KKCL => Chignik 
KKCN => Chernofski 
KKCO => Kocaeli Косаели
KKCR => Colorado Creek 
KKEB => Nanwalek 
KKEH => Kenmore Air Harbor 
KKEK => Ekwok 
KKGX => Grayling 
KKGZ => Glacier Creek 
KKIB => Ivanof Bay 
KKIC => King City 
KKKB => Kitoi Bay 
KKKI => Akiachak 
KKKL => Karluk Lake 
KKKT => Kentland 
KKKU => Ekuk 
KKLL => Levelock 
KKLS => Kelso 
KKMY => Moser Bay 
KKNB => Kanab Канаб
KKNK => Kakhonak 
KKOY => Olga Bay 
KKPB => Point Baker 
KKPH => Pauloff Harbor 
KKPR => Port Williams 
KKPT => Jackpot 
KKPY => Port Bailey 
KKQA => Akutan Акутан
KKSR => Sandy River 
KKTB => Thorne Bay 
KKWF => Waterfall 
KKWK => Kwigillingok 
KKWP => West Point 
KKXA => Kasaan 
KLAA => Lamar 
KLAF => Lafayette 
KLAL => Lakeland 
KLAM => Los Alamos 
KLAN => Lansing Лансинг
KLAR => Laramie 
KLAS => Las Vegas Лас Вегас
KLAS => Mount Etjo Lodge 
KLAS => Mahenye 
KLAS => Midgard 
KLAS => San Matias 
KLAS => Malam 
KLAS => Marlborough Марлборо
KLAW => Lawton 
KLAX => Los Angeles, Ca 
KLBB => Lubbock 
KLBE => Latrobe Латроуб
KLBF => North Platte 
KLBT => Lumberton 
KLBX => Lake Jackson 
KLCH => Lake Charles 
KLCI => Laconia 
KLCK => Columbus 
KLDJ => Linden 
KLDM => Ludington 
KLEB => White River 
KLEE => Leesburg 
KLEM => Lemmon 
KLEW => Lewiston 
KLEX => Waimanalo 
KLEX => Lexington 
KLFI => Hampton 
KLFK => Lufkin, TX 
KLFT => New Iberia 
KLGA => New York Нью-Йорк
KLGB => Long Beach 
KLGC => La Grange 
KLGD => La Grande 
KLGF => Yuma 
KLGU => Logan 
KLHV => Lock Haven 
KLHW => Hinesville 
KLHZ => Louisburg 
KLIC => Limon Лимон
KLIT => Little Rock, AR 
KLIU => Linosa 
KLIV => Livengood, AK 
KLIZ => Limestone 
KLKE => Seattle, WA 
KLKI => Duluth 
KLKP => Lake Placid Лейк Плесид
KLKU => Louisa 
KLKV => Lakeview 
KLLJ => Challis 
KLLN => Kelila Келила
KLMS => Louisville 
KLMT => Klamath Falls Кламмат Фоллз
KLNA => West Palm Beach Уест Палм Бич
KLND => Lander 
KLNK => Lincoln, NE 
KLNN => Willoughby 
KLNP => Wise 
KLNP => Wildwood 
KLNR => Lone Rock 
KLNS => Lancaster 
KLOL => Lovelock 
KLOM => Blue Bell 
KLOR => Ozark 
KLOT => Lockport 
KLOU => Louisville 
KLOZ => London Лондон
KLPC => Lompoc 
KLQK => Pickens 
KLRD => Laredo Ларедо
KLRF => Jacksonville 
KLRJ => Lemars 
KLRK => Lincoln Rock, AK 
KLRN => Moses Lake Мозес Лейк
KLRO => Lathrop 
KLRU => Las Cruces, NM 
KLSB => Lordsburg 
KLSD => Lexington 
KLSE => La Crosse 
KLSF => Columbus 
KLSK => Lusk 
KLSN => Los Banos 
KLSR => Lost River 
KLSV => Las Vegas, NV 
KLTS => Altus 
KLUF => Phoenix Феникс
KLUK => Cincinnati, OH 
KLUL => Laurel, MS 
KLVD => Lime Village 
KLVK => Livermore 
KLVL => Lawrenceville 
KLVM => Livingston Ливингстон
KLVS => Las Vegas Лас Вегас
KLWA => Lwbak 
KLWB => Lewisburg 
KLWC => Lawrence 
KLWL => Wells 
KLWM => Lawrence 
KLWS => Lewiston 
KLWT => Lewistown 
KLWV => Lawrenceville 
KLXN => Lexington 
KLXV => Leadville 
KLYH => Lynchburg Линчбург
KLYO => Lyons 
KMAC => Macon Макон
KMAE => Madera 
KMAF => Midland Мидленд
KMAW => Malden 
KMBG => Mobridge 
KMBL => Manistee 
KMBS => Saginaw, MI 
KMBY => Moberly 
KMCB => Mccomb 
KMCC => Sacramento Сакраменто
KMCD => Mackinac Island 
KMCE => Merced Мерсед
KMCF => Tampa Тампа
KMCI => Kansas City Канзас Сити
KMCK => Mccook 
KMCN => Macon Макон
KMCO => Orlando, FL 
KMCW => Mason City, IA 
KMDA => San Antonio, TX 
KMDD => Midland Мидленд
KMDH => Carbondale 
KMDJ => Madras 
KMDQ => San Rafael Сан-Рафаэль
KMDR => Medfra 
KMDS => Madison 
KMDT => Harrisburg, PA 
KMDW => Chicago Чикаго
KMDZ => Medford 
KMEB => Maxton 
KMEI => Meridian Меридиан
KMEM => Memphis Мемфис
KMER => Atwater, CA 
KMEV => Minden 
KMEZ => Messina Мессина
KMFD => Mansfield 
KMFE => Mc Allen, TX 
KMFH => Mesquite 
KMFI => Marshfield 
KMFR => Medford 
KMFV => Melfa 
KMGC => Michigan City 
KMGE => Marietta 
KMGJ => Montgomery 
KMGM => Montgomery 
KMGR => Moultrie 
KMGW => Morgantown 
KMGY => Dayton 
KMHE => Mitchell Митчелл
KMHK => Manhattan 
KMHL => Marshall Маршалл
KMHN => Mullen 
KMHR => Sacramento, CA 
KMHT => Manchester, NH 
KMHV => Mojave 
KMIA => Miami Майами
KMIB => Minot 
KMIC => Minneapolis Миннеаполис
KMIE => Muncie 
KMIO => Miami Майами
KMIT => Shafter 
KMIV => Millville 
KMIW => Marshalltown 
KMJQ => Jackson Джексон
KMJX => Toms River 
KMKC => Kansas City Канзас Сити
KMKE => Milwaukee Милуоки
KMKG => Muskegon 
KMKL => Jackson Джексон
KMKO => Muskogee 
KMKT => Mankato 
KMKY => Marco Island Марко Айленд
KMLB => Melbourne Мельбурн
KMLC => Mc Alester 
KMLD => Malad City 
KMLE => Maiquetнa 
KMLF => Milford Милфорд
KMLI => Moline 
KMLJ => Milledgeville 
KMLK => Malta Мальта
KMLS => Miles City 
KMLT => Millinocket 
KMLU => Monroe Монро
KMMH => Mammoth Lakes Маммот Лейкс
KMMI => Athens Афины
KMML => Marshall Маршалл
KMMS => Marks 
KMMT => Columbia Колумбия
KMMU => Morristown 
KMMV => Mal 
KMNM => Menominee 
KMNN => Marion 
KMOB => Alabama, AL Алабама
KMOD => Modesto, CA 
KMOP => Mount Pleasant Маунт-Плезант
KMOR => Morristown 
KMOS => Moses Point 
KMOT => Minot 
KMOX => Morris 
KMPE => Madison 
KMPI => Mamitupo Мамитупо
KMPJ => Morrilton 
KMPO => Mt Pocono 
KMPR => Mcpherson 
KMPV => Montpelier, VT 
KMPZ => Mt Pleasant 
KMQB => Macomb 
KMQI => Manteo 
KMQI => Quincy Куинси
KMQJ => Balikesir Балыкесир
KMQS => Coatesville 
KMQW => Mc Rae 
KMQY => Smyrna 
KMRB => Martinsburg 
KMRC => Columbia Колумбия
KMRF => Marfa 
KMRH => May River Мей-Ривер
KMRN => Morganton 
KMRT => Moroak 
KMRY => Monterey Монтерей
KMSL => Sheffield Шеффилд
KMSN => Madison 
KMSO => Missoula 
KMSP => Minneapolis Миннеаполис
KMSS => Massena 
KMSV => Monticello 
KMTH => Marathon Марафон
KMTJ => Montrose 
KMTN => Baltimore Балтимор
KMTO => Mattoon 
KMTP => Montauk 
KMTW => Manitowoc 
KMUI => Fort Indiantown 
KMUL => Moultrie 
KMUO => Mountain Home 
KMUT => Muscatine 
KMUU => Mount Union 
KMVC => Monroeville 
KMVE => Montevideo, MN 
KMVL => Stowe Стоув
KMVM => Kayenta, AZ 
KMVN => Mt Vernon 
KMWA => Marion 
KMWC => Milwaukee Милуоки
KMWH => Moses Lake Мозес Лейк
KMWL => Mineral Wells 
KMWM => Windom, MN 
KMWO => Middletown, Ohio 
KMXA => Manila 
KMXF => Montgomery 
KMXO => Monticello 
KMYF => San Diego Сан Диего
KMYK => May Creek 
KMYL => Mccall 
KMYR => Myrtle Beach Миртл Бич
KMYV => Marysville 
KMZJ => Marana 
KMZZ => Marion 
KNBG => New Orleans Новый Орлеан
KNBJ => Foley 
KNDY => Dahlgren 
KNEL => Lakehurst 
KNEN => Whitehouse 
KNEW => New Orleans Новый Орлеан
KNFL => Fallon 
KNFW => Fort Worth, TX 
KNGP => Corpus Christi Корпус Кристи
KNGU => Norfolk 
KNGW => Corpus Christi Корпус Кристи
KNHK => Patuxent River 
KNHZ => Brunswick 
KNIN => Ninilchik 
KNIP => Jacksonville 
KNJK => El Centro, CA 
KNKX => San Diego Сан Диего
KNLC => Lemoore, CA 
KNPA => Pensacola 
KNQA => Millington, TN 
KNQI => Kingsville 
KNQX => Key West Ки Уэст
KNRB => Mayport 
KNRC => Crows Landing 
KNRS => Imperial Beach 
KNSE => Milton 
KNSF => Camp Springs 
KNTD => Port Hueneme, CA 
KNTU => Oceana 
KNTU => Smith Cove 
KNTU => Siguanea 
KNUN => Pensacola 
KNUQ => Mountain View 
KNUQ => Videira 
KNUQ => Paris Париж
KNUW => Oak Harbor 
KNUW => Deep Bay 
KNVD => Nevada 
KNXX => Willow Grove 
KNYG => Quantico 
KNYL => Yuma 
KNZY => San Diego Сан Диего
KOAJ => Jacksonville 
KOAK => Oakland 
KOAR => Marina, CA 
KOBE => Okeechobee 
KOCF => Ocala Окала
KOCH => Nacogdoches, TX 
KOCW => Washington 
KOEA => Vincennes Винсенн
KOEO => Osceola 
KOFK => Norfolk 
KOGA => Ogallala 
KOGB => Orangeburg 
KOGD => Ogden Огден
KOGS => Ogdensburg 
KOIC => Norwich Норвич
KOJC => Kansas City Канзас Сити
KOKB => Oceanside Оушнсайд
KOKC => Oklahoma City Оклахома Сити
KOKH => Oak Harbor 
KOKK => Kokomo 
KOKM => Okmulgee 
KOKS => Oshkosh 
KOKV => Okao 
KOKV => Winchester 
KOLD => Old Town 
KOLE => Olean 
KOLF => Wolf Point 
KOLM => Olympia Олимпия
KOLS => Nogales Ногалес
KOLU => Columbus, NE 
KOLV => Olive Branch 
KOLY => Olney 
KOMA => Omaha Омаха
KOMA => Omidieh 
KOMK => Omak 
KONA => Winona 
KONL => Oneill 
KONM => Socorro 
KONO => Ontario 
KONP => Newport 
KONT => Ontario 
KONY => Olney 
KOOA => Oskaloosa 
KOPF => Miami Майами
KOPL => Opelousas 
KORD => Chicago, Il 
KORF => Norfolk 
KORH => Worcester 
KORI => Port Lions 
KORL => Orlando Орландо
KORS => Eastsound 
KOSB => Osage Beach 
KOSC => Oscoda 
KOSH => Oshkosh 
KOSU => Columbus 
KOSX => Kosciusko 
KOTG => Worthington 
KOTH => North Bend 
KOTM => Ottumwa 
KOTN => Oaktown 
KOUN => Norman 
KOVE => Oroville 
KOWA => Owatonna 
KOWB => Owensboro 
KOWD => Norwood 
KOWK => Norridgewock 
KOXB => Ocean City 
KOXC => Oxford, CT 
KOXD => Oxford 
KOXR => Ventura Вентура
KOYM => St Marys 
KOZA => Ozona 
KOZR => Ozark 
KPAE => Everett Эверетт
KPAH => Paducah, KY 
KPAK => Hanapepe 
KPAM => Panama City Панама Сити
KPAN => Payson 
KPAO => Palo Alto Пало Альто
KPBF => Pine Bluff 
KPBG => Plattsburgh 
KPBI => Bagani 
KPBI => Burundai Бурундай
KPBI => West Palm Beach Уест Палм Бич
KPBX => Porto Alegre Do Norte 
KPCK => Porcupine Creek 
KPCT => Princeton 
KPDC => Prairie Du Chien 
KPDK => Atlanta, GA 
KPDT => Pendleton 
KPDX => Portland, Or 
KPEC => Pelican 
KPEQ => Pecos City 
KPFC => Pacific City, OH 
KPFN => Panama City Панама Сити
KPGA => Page Паг
KPGD => Punta Gorda Пунта-Горда
KPGM => Port Graham 
KPGR => Paragould 
KPGV => Greenville 
KPHD => New Philadelphia 
KPHF => Nafoora 
KPHF => New York Нью-Йорк
KPHF => Newport News 
KPHG => Port Harcourt 
KPHH => Andrews 
KPHK => Pahokee 
KPHL => Philadelphia Филадельфия
KPHN => Port Huron 
KPHP => Philip 
KPHT => Paris Париж
KPHX => Phoenix Феникс
KPHX => Sitkinak Island 
KPHX => Saposoa Субик-Бей
KPHX => Sao Miguel Do Oeste 
KPHX => Sao Lourenco Do Sul 
KPHX => Svalbard 
KPHX => Sirjan 
KPIA => Peoria, IL 
KPIB => Hattiesburg/Laurel, MS 
KPIE => Clearwater Клируотер
KPIH => Pocatello 
KPIM => Pine Mountain 
KPIR => Pierre 
KPKB => Parkersburg Паркерсбург
KPKD => Park Rapids 
KPKF => Park Falls 
KPLB => Plattsburgh 
KPLK => Branson/point Lookout 
KPLN => Pellston 
KPLR => Pell City 
KPMB => Pembina 
KPMD => Palmdale, Ca 
KPMH => Portsmouth, OH Портсмут
KPMP => Pompano Beach 
KPNC => Ponca City 
KPNE => Philadelphia Филадельфия
KPNN => Princeton 
KPNS => Pensacola 
KPOB => Fayetteville, NC 
KPOC => La Verne 
KPOE => Fort Polk 
KPOF => Poplar Bluff 
KPOH => Pocahontas 
KPOU => Poughkeepsie 
KPOY => Powell 
KPPA => Pampa 
KPPF => Parsons 
KPPO => Laporte 
KPQI => Presque Isle 
KPQL => Pascagoula 
KPRB => Paso Robles 
KPRC => Prescott 
KPRO => Perry 
KPRX => Paris Париж
KPRZ => Prineville 
KPSB => Bellefonte 
KPSC => Pasco, WA 
KPSF => Pittsfield 
KPSK => Dublin Дублин
KPSN => Palestine, TX 
KPSO => Pagosa Springs Пагоса Спрингз
KPSP => Palm Springs Палм Спрингс
KPSQ => Philadelphia Филадельфия
KPSX => Palacios Палачос
KPTB => Petersburg Петерсбург
KPTK => Pontiac 
KPTN => Patterson 
KPTS => Pittsburg 
KPTT => Pratt 
KPTV => Porterville 
KPTW => Pottstown 
KPUB => Pueblo 
KPUC => Price 
KPUW => Pullman 
KPVC => Provincetown 
KPVD => Providence Провиденс
KPVF => Placerville 
KPVU => Port Johnson 
KPVU => Provo 
KPVW => Plainview 
KPWA => Oklahoma City Оклахома Сити
KPWD => Plentywood 
KPWK => Chicago Чикаго
KPWM => Portland Портланд
KPWR => Port Walter 
KPWT => Bremerton 
KPYL => Perry Island 
KPYM => Plymouth 
KQBF => Vail/Eagle 
KQKB => Breckenridge 
KQKS => Keystone 
KQNY => New York Нью-Йорк
KQWP => Winter Park 
KRAC => Racine Рацине
KRAD => Warroad 
KRAL => Riverside 
KRAP => Rapid City Рапид Сити
KRAP => Ravensthorpe 
KRBD => Dallas Даллас
KRBE => Ratanakiri 
KRBG => Roseburg Розбург
KRBL => Red Bluff 
KRBN => Fort Jefferson 
KRBW => Walterboro 
KRCA => Rapid City Рапид Сити
KRCK => Rockdale 
KRCR => Rochester Рочестер
KRCT => Reed City 
KRDD => Redding 
KRDG => Reading 
KRDM => Redmond 
KRDR => Red River Ред Ривер (Красная река)
KRDU => Raleigh/Durham 
KRDV => Red Devil 
KREO => Rome Рим
KRFD => Rockford Рокфорд
KRFG => Refugio 
KRFK => Anguilla 
KRHI => Rhinelander 
KRHV => San Jose Сан-Хосе
KRIC => Richmond, VA 
KRID => Richmond, IN 
KRIF => Richfield 
KRIL => Rifle 
KRIR => Riverside 
KRIV => Riverside 
KRIW => Riverton, WY 
KRKC => Yreka Ирека
KRKD => Rockland 
KRKP => Rockport 
KRKR => Poteau 
KRKS => Rock Springs Рок Спрингс
KRKW => Rockwood 
KRLD => Richland 
KRME => Rome, NY 
KRMG => Rome Рим
KRMP => Rampart 
KRNC => Mcminnville 
KRND => San Antonio Сен Антонио
KRNH => New Richmond 
KRNP => Rongelap Island 
KRNT => Renton, WA 
KROA => Roanoke 
KROC => Rochester, NY 
KROG => Rogers 
KROW => Roswell 
KROX => Roseau 
KRPD => Rice Lake 
KRPX => Roundup 
KRQB => Big Rapids 
KRRL => Merrill 
KRSL => Russell Расселл
KRSN => Ruston 
KRST => Rochester Рочестер
KRSW => Fort Myers Форт Майерс
KRTL => Spirit Lake 
KRTN => Raton 
KRUQ => Salisbury 
KRUT => Rutland Рутленд
KRVL => Reedsville 
KRVS => Tulsa Тулса
KRWF => Redwood Falls 
KRWI => Rocky Mount, 
KRWL => Rawlins 
KRZL => Rensselaer 
KRZZ => Roanoke Rapids 
KSAA => Saratoga 
KSAC => Sacramento Сакраменто
KSAD => Safford 
KSAF => Santa Fe Санта Фе
KSAG => Sagwon 
KSAN => San Diego Сан Диего
KSAR => Sparta Спарта
KSAS => Salton City 
KSAT => San Antonio Сен Антонио
KSAV => Savannah Саванна
KSAW => Marquette 
KSBA => Santa Barbara Санта-Барбара-Ба
KSBD => San Bernardino Сан Бернардино
KSBM => Sheboygan 
KSBN => South Bend 
KSBO => Salina 
KSBP => San Luis Obispo Сан Луис Обиспо
KSBS => Steamboat Springs 
KSBX => Shelby 
KSBY => Salisbury-Ocean City 
KSCB => Scribner 
KSCH => Schenectady, NY 
KSCK => Stockton 
KSDF => Louisville, KY 
KSDL => Phoenix Феникс
KSDM => San Diego Сан Диего
KSDY => Sidney 
KSEA => Seattle, WA 
KSEA => Takume 
KSEE => San Diego Сан Диего
KSEF => Sebring, Fl 
KSEG => Selinsgrove 
KSEM => Selma 
KSEP => Stephenville 
KSER => Seymour 
KSEZ => Sedona Седона
KSFB => Sanford 
KSFF => Spokane Спокане
KSFM => Sanford 
KSFO => San Francisco, CA 
KSFZ => Pawtucket, RI 
KSGF => Springfield 
KSGH => Springfield 
KSGJ => St Augustine Сент Огустин
KSGR => Houston, TX 
KSGT => Stuttgart, AR 
KSGU => Saint George 
KSHD => Staunton 
KSHN => Shelton 
KSHR => Sheridan 
KSHV => Shreveport Шревспорт
KSIK => Sikeston 
KSIV => Sullivan 
KSIY => Montague 
KSJC => Garden City 
KSJC => San Jose Сан-Хосе
KSJC => Campbell River Кэмпбелл Ривер
KSJC => Ekati 
KSJN => St Johns Сент Джонс
KSJT => San Angelo 
KSKA => Spokane Спокане
KSKF => San Antonio Сен Антонио
KSKX => Taos Таос
KSKY => Sandusky Сандуски
KSLB => Storm Lake Сторм Лейк
KSLC => Lokichoggio 
KSLC => Salt Lake City, UT 
KSLE => Salem 
KSLG => Siloam Springs 
KSLJ => Chandler Чандлер
KSLK => Saranac Lake 
KSLN => Salina 
KSLO => Salem 
KSLR => Sulphur Springs 
KSMD => Fort Wayne, IN 
KSME => Somerset 
KSMF => Sacramento, CA 
KSMN => Salmon 
KSMO => Santa Monica Санта Моника
KSMS => Sumter 
KSMX => Santa Maria Санта-Мария
KSNA => Orange County 
KSNK => Snyder 
KSNL => Shawnee 
KSNS => Salinas 
KSNY => Sidney 
KSOA => Soc Trang Сок-Транг
KSOP => Southern Pines 
KSOW => Show Low, AZ 
KSPA => Spartanburg, SC 
KSPB => St Thomas Island 
KSPF => Spearfish 
KSPG => Petersburg, AK 
KSPI => Springfield 
KSPQ => San Pedro Сан-Педро
KSPS => Wichita Falls 
KSPW => Spencer 
KSPX => Houston Хьюстон
KSQI => Sterling Rockfalls 
KSQL => San Carlos Сан Карлос
KSRC => Searcy 
KSRQ => Sarasota, FL 
KSRR => Ruidoso 
KSRR => Stradbroke Island 
KSRV => Stony River 
KSSC => Sumter 
KSSF => San Antonio Сен Антонио
KSSI => Brunswick 
KSTC => Saint Cloud 
KSTE => Stevens Point 
KSTJ => St Joseph 
KSTK => Sterling 
KSTL => St Louis Сент Луис
KSTP => St Paul Сен Поль
KSTS => Santa Rosa Санта-Роса
KSUA => Stuart 
KSUA => Waldron Island 
KSUA => Waddington 
KSUD => Stroud 
KSUE => Sturgeon Bay 
KSUN => Sun Valley 
KSUO => Sun River Сан-Ривер, шт. Орегон
KSUS => St Louis Сент Луис
KSUU => Fairfield 
KSUW => Superior 
KSUX => Dalgaranga 
KSUX => Sioux City Сиокс Сити
KSVC => Silver City 
KSVE => Susanville 
KSVH => Statesville 
KSVN => Savannah, GA 
KSVS => Stevens Village 
KSWF => Newburgh 
KSWO => Stillwater 
KSWW => Sweetwater 
KSXP => Sheldon Point 
KSYF => Silva Bay 
KSYI => Shelbyville 
KSYL => San Miguel Сан-Мигель
KSYN => Stanton 
KSYR => Syracuse Сиракус
KSYV => Sylvester 
KSZL => Knights Inlet 
KSZL => Warrensburg Варренсбург
KSZN => Santa Barbara Санта-Барбара-Ба
KSZP => Santa Paula 
KTAD => Trinidad Тринидад
KTBN => Fort Leonard Wood 
KTBR => Statesboro, GA 
KTCC => Tucumcari Тукумкари
KTCL => Tuscaloosa 
KTCM => Tacoma, WA 
KTCS => Truth Or Consequences 
KTCT => Takotna 
KTCY => Terrace Bay 
KTDO => Aleneva 
KTDO => Toledo Толедо
KTDW => Amarillo Амарильо
KTDZ => Toledo Толедо
KTEB => Teterboro 
KTEW => Tohid 
KTEX => Telluride 
KTHA => Tullahoma, TN 
KTHM => Thompsonfield 
KTHP => Thermopolis Термополис
KTHV => York 
KTIK => Oklahoma City Оклахома Сити
KTIW => Tacoma Такома
KTIX => Titusville 
KTKE => Tenakee Springs 
KTKI => Tokeen 
KTKL => Taku Lodge 
KTKX => Kennett 
KTLH => Tallahassee Таллахасси
KTLR => Tulare, CA 
KTLT => Tuluksak 
KTMA => Tifton, GA 
KTMB => Miami Майами
KTNP => Twentynine Palms 
KTNT => Miami Майами
KTNU => Newton Ньютон
KTNX => Tonopah Тонопа
KTOA => Torrance Торранс
KTOC => Toccoa 
KTOI => Troy 
KTOL => Toledo, OH 
KTOP => Topeka 
KTOR => Torrington 
KTPA => Tampa Тампа
KTPH => Tonopah Тонопа
KTPL => Temple, TX 
KTRH => Trona 
KTRI => Blountville 
KTRI => Tremonton 
KTRK => Truckee, CA 
KTRL => Terrell 
KTRM => Thermal 
KTRP => Tree Point 
KTRX => Trenton 
KTSG => Tanacross Танакросс
KTSP => Tehachapi, CA 
KTTD => Troutdale 
KTTN => Trenton, NJ 
KTUL => Tulsa Тулса
KTUP => Tupelo Тупело
KTUS => Tucson, AZ 
KTVC => Traverse City город Траверсе
KTVF => Thief River Falls 
KTVI => Thomasville 
KTVL => South Lake Tahoe Южное Озеро Тахо
KTWF => Twin Falls, ID 
KTWT => Tawitawi 
KTXK => Texarkana 
KTXK => Wahai 
KTYE => Tyonek 
KTYL => Taylor Тейлор
KTYR => Tyler 
KTYS => Knoxville Ноксвилл
KUBS => Columbus 
KUCA => Utica 
KUCC => Yucca Flat 
KUCC => Chute-Des-Passes 
KUCY => Union City 
KUDD => Palm Springs Палм Спрингс
KUES => Waukesha Ваукеша
KUES => Manly 
KUGB => Pilot Point 
KUGN => Waukegan 
KUIL => Quillayute 
KUIN => Quincy Куинси
KUIZ => Utica 
KUKF => Wilkesboro 
KUKI => Ukiah 
KUKT => Quakertown 
KULM => New Ulm 
KUNI => Athens Афины
KUNU => Juneau,  WI 
KUNV => State College 
KUOS => Sewanee 
KUOX => Oxford 
KUUU => Newport 
KUVA => Uvalde 
KUWA => Ware 
KUZA => Rock Hill 
KVAD => Valdosta 
KVAY => Mount Holly 
KVBG => Lompoc 
KVBT => Theda 
KVCB => View Cove 
KVCT => Victoria Лимбе
KVCV => Victorville, CA 
KVDI => Vidalia 
KVEL => Vernal, UT 
KVGT => Las Vegas Лас Вегас
KVHN => Van Horn 
KVIH => Roosevelt 
KVIH => Vichy Вичи
KVIS => Visalia 
KVJI => Abingdon Абингдон
KVKS => Vicksburg Виксбург
KVLA => Vandalia 
KVLD => Valdosta 
KVNC => Venice, FL 
KVNY => Los Angeles Лос Анджелес
KVOK => Camp Douglas 
KVPS => Valparaiso, FL 
KVPZ => Valparaiso Вальпараисо
KVQQ => Jacksonville 
KVRB => Vero Beach Веро Бич
KVRB => Matanzas Матансас
KVRS => Versailles Версаль
KVSF => Springfield 
KVTN => Valentine 
KVYS => Peru Перу
KWAL => Chincoteague 
KWAY => Waynesburg 
KWBB => Stebbins 
KWBN => Woburn 
KWBW => Wilkes-Barre, PA 
KWDG => Enid 
KWDR => Winder 
KWDY => Kodiak 
KWEA => Weatherford 
KWHP => Los Angeles Лос Анджелес
KWJF => Fox 
KWJF => Lancaster 
KWLB => Labouchere Bay 
KWLD => Winfield 
KWLM => Waltham 
KWLR => Loring 
KWLW => Willows 
KWMC => Winnemucca 
KWMK => Meyers Chuck 
KWNC => Tuxekan Island 
KWOD => Wood River 
KWPO => Paonia 
KWRB => Macon Макон
KWRI => Wrightstown, New Jersey 
KWRL => Worland, WY 
KWSB => Steamboat Bay 
KWSD => White Sands 
KWSJ => San Juan Сан Хуан
KWSM => Wiseman 
KWST => Westerly 
KWSX => Westsound 
KWTL => Tuntutuliak 
KWTR => White River 
KWVI => Watsonville 
KWVL => Waterville Уотервилл
KWWD => Wildwood 
KWWP => Whale Pass 
KWWR => Woodward 
KWYB => Yes Bay 
KWYS => West Yellowstone Уест Йеллоустоун
KXNA => Fayetteville, AR 
KXPU => West Kuparuk 
KXSA => Sinoe Синоу
KYIP => Detroit, MI 
KYKM => Yakima Якима
KYKN => Yankton 
KYNG => Youngstown 
KZBP => Baltimore Балтимор
KZEF => Nanhai 
KZER => Providence Провиденс
KZPH => Zephyrhills 
KZZV => Zanesville Занесвилл
LATI => Tirana 
LBBG => Bourgas Бургас
LBGO => Gorna Oriahovitsa 
LBPD => Plovdiv Пловдив
LBRS => Rousse 
LBSF => Sofia София
LBSZ => Stara Zagora Стара-Загора
LBWN => Varna Варна
LCEN => Lefkosa 
LCLK => Larnaca Ларнака
LCNC => Nicosia Никозия
LCPH => Paphos Пафос
LCPH => Painesville 
LCRA => Akrotiri Акротири
LCRO => Episkopi Эпископи
LDDU => Dubrovnik Дубровник
LDLO => Mali Losinj 
LDOS => Osijek Осиек
LDPL => Pula Пула
LDRI => Rijeka Риека
LDSB => Bol Бол
LDSP => Split Сплит
LDZA => Zagreb Загреб
LDZD => Zadar Задар
LEAB => Albacete Албасет
LEAL => Alicante Аликанте
LEAM => Almeria Алмерия
LEAS => Oviedo/Aviles 
LEBA => Cordoba Кордова
LEBB => Bilbao Билбао
LEBL => Barcelona Барселона
LEBZ => Badajoz Бадахос
LECO => La Coruna Ла Коруна
LEGE => Gerona Герона
LEGR => Granada Гранада
LEHC => Huesca Хуэска
LEIB => Ibiza Ибица
LEJR => Jerez De La Frontera 
LELC => Murcia Мурсия
LELN => Leon Леон
LELO => Logrono Логроно
LEMD => Madrid Мадрид
LEMG => Malaga Малага
LEMG => Boxborough 
LEMG => Bunsil 
LEMG => Port San Juan 
LEMG => Puerto De Santa Maria 
LEMH => Menorca 
LEMO => Moron 
LEPA => Palma Mallorca 
LEPP => Pamplona Памплона
LERS => Reus Реус
LESA => Salamanca Саламанка
LESO => San Sebastian Сан-Себастьян
LEST => Santiago De Compostela Сантьяго де Компостела
LESU => Seu De Urgel 
LETO => Madrid Мадрид
LEVC => Valencia Валенсия
LEVD => Valladolid Вальядолид
LEVT => Vitoria. 
LEVX => Vigo Виго
LEXJ => Santander Сантандер
LEZG => Zaragoza Сарагоса
LEZL => Sevilla 
LFAB => Dieppe Дьеп
LFAC => Clearlake 
LFAC => Calais Кале
LFAE => Abu Musa 
LFAT => Le Touquet 
LFBA => Agen Аген
LFBD => Bordeaux Бордо
LFBE => Bergerac Бержерак
LFBG => Cognac Коньяк
LFBH => La Rochelle Ла Рошель
LFBH => Lubbock 
LFBI => Poitiers Пуатье
LFBL => Limoges Лимож
LFBN => Niort Ниорт
LFBO => Toulouse Тулуз
LFBP => Pau По
LFBT => Lourdes/Tarbes 
LFBU => Angouleme Ангулем
LFBV => Brive-La-Gaillarde Брив-ла-Гайард
LFBX => Perigueux Периге
LFBZ => Biarritz Биарриц
LFCC => Cahors Каор
LFCI => Albi Альби
LFCK => Castres Кастре
LFCR => Rodez Родез
LFCY => Royan Ройан
LFDJ => Pambwa Памбва
LFDN => Rochefort Рошфор
LFDT => Ramadan Рамадан
LFGA => Colmar Колмар
LFGJ => Dole 
LFGO => Yandicoogina 
LFHM => Megeve Межев
LFHO => Aubenas Обенас
LFHP => Le Puy Ле-Пуй
LFHU => Alpe D Huez 
LFHU => LingLing 
LFIO => Toulouse Тулуз
LFJL => Metz/nancy 
LFJR => Angers Анжер
LFKB => Bastia Бастия
LFKC => Calvi Кальви
LFKC => Kelp Bay 
LFKF => Figari 
LFKJ => Ajaccio Аяччио
LFKO => Propriano Проприано
LFKS => Solenzara 
LFKX => Meribel Мерибел
LFLA => Auxerre 
LFLB => Chambery Шамбери
LFLC => Clermont-Ferrand Клермон-Ферран
LFLD => Bourges Борже
LFLJ => Courchevel Куршевель
LFLL => Lyon Лион
LFLN => Saint Yan 
LFLO => Roanne Руан
LFLP => Annecy Аннеси
LFLS => Grenoble Гренобль
LFLT => Montlucon Монлукон
LFLU => Valence Валенс
LFLV => Vichy Вичи
LFLW => Aurillac Орийак
LFLX => Chateauroux Шаторуа
LFLY => Lyon Лион
LFMD => Cannes Канны
LFMH => St Etienne Сент Етьенн
LFMK => Carcassonne Каркассон
LFML => Marseille Марсель
LFMP => Perpignan Перпиньян
LFMQ => Le Castellet Ле-Кастейе
LFMR => Barcelonnette Барселонетта
LFMT => Montpellier Монпейе
LFMU => Beziers Безьер
LFMV => Avignon Авиньон
LFNA => Gap Гап
LFNB => Mende Менде
LFNC => St Crepin 
LFOB => Paris Париж
LFOE => Evreux Эвро
LFOE => Flora Valley 
LFOH => Le Havre Ле Хавре
LFOJ => Orleans Орлеан
LFOK => Chalons Sur Marne 
LFOO => Les Sables Лес-Саблес
LFOP => Rouen Руан
LFOT => Tours Турс
LFOU => Cholet Шоле
LFOV => Laval Лаваль
LFPB => Paris Париж
LFPC => Creil 
LFPG => Paris Париж
LFPG => Dearborn Диарборн
LFPG => Sumare 
LFPG => Sawan 
LFPN => Toussus-Le-Noble 
LFPO => Paris Париж
LFPT => Paris Париж
LFPY => Norwalk 
LFQG => Nevers Неверс
LFQQ => Lille Лилль
LFQT => Hazebrouck Хазебрук
LFRB => Brest Брест
LFRC => Cherbourg Шербург
LFRD => Dinard Динард
LFRE => Saint Nazaire Сен Назер
LFRF => Granville Гранвиль
LFRG => Deauville Дювиль
LFRH => Lorient Лориент
LFRI => La Roche Ла-Рош
LFRJ => Landivisiau 
LFRK => Caen Кан
LFRM => Le Mans Ле Манс
LFRN => Rennes Ренн
LFRO => Lannion Ланнион
LFRQ => Quimper Куимпер
LFRS => Nantes Нант
LFRT => Tremuson 
LFRU => Morlaix 
LFRV => Vannes Ваннес
LFRZ => St Nazaire 
LFSB => Mulhouse/basel 
LFSB => Basel Mulhouse Freiburg 
LFSD => Dijon Дижон
LFSF => Metz Мец
LFSG => Epinal Эпиналь
LFSN => Nancy Ненси
LFSQ => Belfort Белфорт
LFSR => Reims Реймс
LFST => Strasbourg Страсбург
LFSZ => Vittel Виттель
LFTH => Hyeres Хиерес
LFTU => Frejus Фрехус
LFTW => Nimes Ним
LFTZ => Saint Tropez 
LFVM => Miquelon Микелон
LFVP => St Pierre 
LFYH => Juan Les Pins 
LGAD => Pyrgos Пиргос
LGAG => Agrinion Агринио
LGAL => Alexandroupolis Александрополи
LGAV => Athens Афины
LGBL => Volos Волос
LGHI => Chios Чиос
LGHL => Porto Kheli 
LGIK => Ikaria Island 
LGIO => Ioannina Иоаннина
LGIR => Heraklion 
LGKA => Kastoria Кастория
LGKC => Kithira Китира
LGKF => Kefalonia Кефалония
LGKJ => Kastelorizo Кастелоризо
LGKL => Kalamata Каламата
LGKO => Kos Кос
LGKP => Karpathos Карпатос
LGKR => Kerkyra 
LGKS => Kasos Island 
LGKV => Kavala Кавала
LGKZ => Kozani Козани
LGLE => Leros Лерос
LGLM => Limnos 
LGLR => Larisa Лариса
LGMK => Mikonos Миконос
LGML => Milos Милос
LGMT => Mytilene 
LGNX => Naxos Наксо
LGPA => Paros Парос
LGPL => Astypalaia Island 
LGPZ => Preveza/Lefkas Превеза-Лефка
LGRP => Rhodes Родос
LGRX => Patras Патрас
LGSA => Chania 
LGSK => Skiathos Скиатлос
LGSM => Samos 
LGSO => Syros Island Сирос-Айленд
LGSP => Athens Афины
LGSR => Santorini (Thira) 
LGST => Sitia 
LGSY => Skiros Скирос
LGTS => Thessaloniki Салоники
LGZA => Zakinthos 
LHBP => Budapest Будапешт
LHDC => Debrecen Дебрецен
LHMC => Miskolc Мискольц
LHSM => Saarmelleek 
LIBC => Crotone Кротон
LIBD => Bari Бари
LIBF => Foggia Фоджия
LIBG => Taranto Таранто
LIBN => Lecce Лечче
LIBP => Pescara Пескара
LIBR => Brindisi Бриндиси
LICA => Lamezia-terme 
LICB => Comiso Комизо
LICC => Catania Катания
LICD => Lampedusa 
LICG => Pantelleria 
LICJ => Palermo Палермо
LICR => Reggio Calabria Редджио-Калабрия
LICT => Trapani Тапини
LICZ => Tokat Токат
LIDB => Belluno Беллуно
LIDE => Luzern Люцерн
LIDR => Ravenna Равенна
LIEA => Alghero 
LIED => Decimomannu 
LIED => Rosita 
LIEE => Cagliari Кальяри
LIEO => Olbia 
LIET => Tortoli 
LIMC => Milan Милан
LIME => Bergamo Бергамо
LIMF => Turin Турин
LIMG => Albenga Албенга
LIMJ => Genova 
LIML => Milan Милан
LIMP => Parma Парма
LIMW => Aosta Аоста
LIMW => Ganes Creek 
LIMZ => Cuneo Кунео
LIPA => Aviano 
LIPB => Bolzano Болзано
LIPD => Udine 
LIPE => Bologna Болонья
LIPE => Gravatai 
LIPH => Treviso Тревисо
LIPK => Forli Форли
LIPO => Brescia Бресия
LIPQ => Trieste Триест
LIPR => Rimini Римини
LIPT => Vicenza Виченца
LIPX => Verona Верона
LIPY => Ancona Анкона
LIPZ => Venice Венеция
LIQC => Capri Капри
LIQL => Lucca Лучча
LIQS => Siena Сиенна
LIRA => Rome Рим
LIRF => Rome Рим
LIRJ => Elba Island Остров Эльба
LIRN => Napoli 
LIRP => Pisa Пиза
LIRQ => Florence Флоренция
LIRS => Grosseto Гроссето
LIRV => Forrest River 
LIRZ => Mili Atoll 
LIRZ => Perugia Перужия
LIVV => Vangaindrano 
LJLJ => Ljubljana Любляна
LJMB => Maribor Марибор
LJPZ => Portoroz Порторос
LKHO => Zlin Злин
LKKU => Uherske Hradiste Угерске-Градиште
LKKV => Karlovy Vary Карловы-Вары
LKMR => Marianske Lazne Марианские Лазнe
LKMT => Ostrava Острава
LKOL => Olomouc Оломоуц
LKPD => Pardubice Пардубицы
LKPM => Dolomi 
LKPO => Prerov Пршеров
LKPR => Prague Прага
LKTB => Brno Брно
LKZA => Zabreh Забржег
LLAZ => Gush Katif Гуш-Катиф
LLBG => Tel Aviv Yafo Ben-Gurion Бен-Гурион
LLBS => Beer Sheba 
LLBS => Shanhaiguan Шаньягван
LLET => Eilat Эйлат
LLEY => Ein Yahav Эйн-Яхав
LLHA => Haifa Хайфа
LLIB => Rosh Pina Рош Пина
LLKS => Kiryat Shmona Кирьят-Шемона
LLMZ => Masada Масада
LLMZ => Kasba Lake 
LLMZ => Obre Lake 
LLOV => Eilat Эйлат
LLRM => Mitspeh Ramon 
LLSD => Dora Bay 
LLSD => Tel Aviv Yafo 
LLYT => Yotvata 
LMMG => Gozo Гозо
LMML => Gudja 
LNMC => Monte Carlo Монте-Карло
LOIH => Hohenems Хохенемс
LOIR => Marguerite Bay 
LOWG => Graz Грац
LOWI => Innsbruck Инсбрук
LOWK => Klagenfurt Клагенфурт
LOWL => Linz Линц
LOWS => Salzburg Зальцбург
LOWW => Vienna Вена
LOWW => Vallemi 
LOWZ => Pasir Gudang 
LPAZ => Motswari 
LPAZ => Santa Maria Санта-Мария
LPBG => Braganca Браганса
LPBJ => Peschiei 
LPBR => Braga Брага
LPCH => Chaves Чавес
LPCO => Coimbra Коимбра
LPCR => Corvo Island 
LPCV => Covilha Ковилья
LPEV => Baton Rouge Батон Руж
LPFL => Flores Island 
LPFR => Faro Фаро
LPGR => Graciosa Island 
LPHR => Roma 
LPHR => Horta 
LPLA => Great Bear Lake 
LPLA => Terceira Island 
LPMA => Funchal 
LPMR => Shangri-la 
LPOT => Otto 
LPOV => Olavarria 
LPPD => Ponta Delgada 
LPPI => Pico Island 
LPPM => Portimao Портиман
LPPR => Porto Порто
LPPS => Porto Santo Порто Санто
LPPT => Loncopue 
LPPT => Lisbon Лиссабон
LPSI => Sines Синес
LPSJ => Sao Jorge Island 
LPVR => Vila Real Вила-Реал
LPVZ => Viseu Визеу
LQBK => Banja Luka Баня-Лука
LQBK => Peng Lai 
LQMO => Mostar Мостар
LQSA => Sarajevo Сараево
LQTZ => Tuzla Тузла
LRAR => Arad Арад
LRBC => Bacau Бакэу
LRBM => Baia Mare Байя Маре
LRBS => Bucharest Бухарест
LRCK => Constanta Константа
LRCL => Cluj-Napoca Клуж-Напока
LRCS => Caransebes Карансебеш
LRCV => Craiova Крайова
LRDV => Deva Дева
LRIA => Iasi Иаси
LROD => Oradea Орадя
LROP => Bucharest Бухарест
LRSB => Sibiu Сибиу
LRSM => Satu Mare Сату Маре
LRSV => Suceava Сучава
LRTC => Tulcea Тулча
LRTM => Tirgu Mures Тиргу Мурес
LRTR => Timisoara Тимисоара
LSGG => Geneva Женева
LSGS => Sion Сион
LSZA => Lugano/Agno 
LSZB => Berne Берне
LSZD => Ascona Аскона
LSZH => Zurich Цюрих
LSZR => Altenrhein 
LSZS => St Moritz Сент Мориц
LTAC => Ankara Анкара
LTAD => Ankara Анкара
LTAF => Adana Адана
LTAG => Adana Адана
LTAH => Afyon Афион
LTAI => Antalya Анталия
LTAJ => Gaziantep Газиантеп
LTAN => Konya Конья
LTAP => Merzifon Мерзифон
LTAR => Sivas Сивас
LTAT => Malatya Малатия
LTAU => Kayseri Кайсери
LTAW => Tokat Токат
LTAY => Denizli Денизли
LTBA => Istanbul Стамбул
LTBE => Bursa Бурса
LTBF => Balikesir Балыкесир
LTBG => Bandirma Бандирма
LTBH => Canakkale Канаккале
LTBI => Eskisehir Эскишехир
LTBJ => Izmir Измир
LTBL => Izmir Измир
LTBO => Usak Асак
LTBR => Bursa Бурса
LTBS => Dalaman Даламан
LTBU => Tekirdag Текиргад
LTBV => Bodrum Бодрум
LTCA => Elazig Элязыг
LTCC => Diyarbakir Диярбакыр
LTCD => Erzincan Эрзинкан
LTCE => Erzurum Эрзурум
LTCF => Kars Карс
LTCG => Trabzon Трабзон
LTCH => Sanliurfa 
LTCI => Van Ван
LTCJ => Batman 
LTCK => Mus Муш
LTCL => Siirt Сиирт
LTCM => Sinop Синоп
LTCO => Agri Агри
LTCP => Adiyaman 
LTCR => Mardin Мардин
LTFC => Isparta Испарта
LTFD => Edremit/korfez 
LTFE => Bodrum Бодрум
LTFH => Samsun/carsamba 
LTFH => Samsun Самсун
LTFJ => Istanbul Стамбул
LUBL => Beltsy Бельцы
LUKK => Chisinau Кишинев
LWOH => Ohrid Охрид
LWSK => Skopje Скопье
LXGB => Gibraltar Гибралтар
LYBE => Belgrade Белград
LYBR => Berane 
LYBT => Belgrade Белград
LYNI => Nis Ниш
LYNI => Simberi Island 
LYPG => Podgorica 
LYTV => Tivat Тиват
LYUZ => Uzice 
LZIB => Bratislava Братислава
LZKZ => Kosice Косице
LZLU => Lucenec Лученец
LZPP => Piestany Пиестани
LZPW => Presov 
LZSL => Sliac Шлияк
LZTT => Poprad Попрад
LZZI => Zilina Жилина
MBGT => Grand Turk Is 
MBGT => Ji An 
MBMC => Middle Caicos Миддл-Кайкос
MBNC => North Caicos Норт-Кайкос
MBPI => Pine Cay Пайн-Кей
MBPV => Providenciales 
MBSC => South Caicos 
MBSY => Salt Cay 
MDAB => Samana Самана
MDBH => Barahona Барахона
MDCR => Cabo Rojo Кабо-Рожо
MDCZ => Constanza Констанца
MDHE => Santo Domingo Санто-Доминго
MDLR => La Romana Ла-Романа
MDMC => Mt Clemens 
MDPC => Higlieg 
MDPC => Higuey 
MDPP => Puerto Plata Пуэрто Плата
MDSB => Sabana De Mar 
MDSD => Kamur 
MDSD => Santo Domingo Санто-Доминго
MDSJ => San Juan Сан Хуан
MDST => Santiago Сантьяго
MEMO => Moengo 
MGCB => Coban Кобан
MGCR => Carmelita Кармелита
MGCT => Coatepeque 
MGGT => Guatemala City Гватемала Сити
MGHT => Huehuetenango Хухутенанго
MGMM => Melchor De Menco 
MGPB => Puerto Barrios Пуэрто Барриос
MGPP => Poptun Поптун
MGQC => Quiche 
MGQZ => Ambriz 
MGRB => Rubelsanto Рубелсанто
MGRT => Retalhuleu 
MGTK => Flores Флорес
MGTK => Tikal Тикал
MGZA => Kuantan Куантан
MGZA => Perth Перт
MHBL => Brus Laguna Брюс-Лагуна
MHCA => Catacamas Катакамас
MHJU => Juticalpa Хутикальпа
MHLC => La Ceiba 
MHLE => La Esperanza 
MHLM => Macmahon Camp 4 
MHLM => Mount Shasta 
MHLM => Mount Pleasant Маунт-Плезант
MHLM => Mount Wilson 
MHLM => Mechria 
MHLM => San Pedro Sula 
MHMA => Marcala Маркала
MHNJ => Guanaja 
MHOA => Olanchito Оланчито
MHPL => Puerto Lempira 
MHRO => Roatan Роатан
MHRU => Copan Копан
MHSC => Comayagua Комаягуа
MHSR => Santa Rosa Copan 
MHTE => Tela Тела
MHTG => Tegucigalpa Тегусигальпа
MHTJ => Trujillo Трухилло
MHUT => Utila 
MHYR => Yoro Йоро
MKBS => Oceanic 
MKBS => Ocho Rios Очо Риос
MKJP => Kingston Кингстоун
MKJS => Montego Bay Монтего Бей
MKKJ => Port Antonio Порт-Антонио
MKNG => Negril Негрил
MKTP => Kingston Кингстоун
MLIP => Mili Island 
MMAG => Apatzingan Апацинган
MMAN => Tuxtla Gutierrez Тухтла-Гутьеррес
MMAS => Aguascalientes Агуаскалиентес
MMBT => Huatulco Хуатулко
MMCA => Cananea Кананеа
MMCB => Cuernavaca Куернавака
MMCC => Ciudad Acuna Сиудад-Акуна
MMCE => Ciudad Del Carmen 
MMCG => Paloma Grande 
MMCL => Culiacan 
MMCM => Chetumal Четумал
MMCN => Ciudad Obregon Сиудад-Обрегон
MMCO => Comitan 
MMCP => Campeche Кампеше
MMCP => Zonguldak Зонгулдаг
MMCS => Ciudad Juarez Сиудад Хуарез
MMCT => Chichen Itza Чинчен Ица
MMCT => Ila Da Chilonzuene 
MMCU => Chihuahua Чихуахуа
MMCV => Ciudad Victoria Сиудад-Виктория
MMCZ => Cozumel Коцумел
MMDA => Ciudad Constitucion Сиудад-Конститусьон
MMDM => Ciudad Mante Сиудад-Манте
MMDO => Durango Дуранго
MMEP => Taormina Таормина
MMEP => Tepic Тепик
MMES => Ensenada 
MMGL => Guadalajara Гуадалахара
MMGM => Guaymas 
MMGR => Guerrero Negro Гверреро-Негро
MMHC => Tehuacan Теуакан
MMHO => Hermosillo Хермосилльо
MMIA => Colima Колима
MMIM => Isla Mujeres Айла Мухерес
MMIO => Saltillo Сальтильо
MMIT => Ixtepec Ихтепек
MMJA => Jalapa Халапа
MMLC => Lazaro Cardenas Лацаро-Карденас
MMLM => Los Mochis Лос-Мошис
MMLO => Leуn 
MMLP => La Paz Ла Пас
MMLT => Loreto Лорето
MMMA => Matamoros Матаморос
MMMD => Merida Мериба
MMMG => Mulege Мулеж
MMML => Mexicali 
MMMM => Morelia Морелия
MMMT => Minatitlan Минатитлан
MMMV => Monclova Монклова
MMMX => Mexico City Мексико Сити
MMMY => Monterrey Монтеррей
MMMZ => Mazatlan Мазатлан
MMNG => Nogales Ногалес
MMNL => Nuevo Laredo 
MMOX => Oaxaca Оксака
MMPA => Poza Rica Поса-Рика
MMPB => Puebla Atlixco 
MMPE => Puerto Penasco Пуэрто-Пенаско
MMPG => Piedras Negras Пьедрас-Неграс
MMPL => Punta Colorada Пунта-Колораде
MMPN => Uruapan Уруапан
MMPQ => Palenque Паленке
MMPR => Puerto Vallarta Пуэрто Ваярта
MMPS => Puerto Escondido Пуэрто Эскондидо
MMQT => Queretaro Керетаро
MMRX => Reynosa 
MMSC => S.Cristobal deL Casas 
MMSD => San Jose Del Cabo 
MMSF => San Felipe Сан-Фелипе
MMSP => San Luis Potosi Сан-Луис-Потоси
MMSZ => Salina Cruz Залина-Крус
MMTC => Torreon Торреон
MMTG => Tingrela 
MMTG => Tuxtla Gutierrez Тухтла-Гутьеррес
MMTJ => Tijuana Тихуана
MMTM => Tampico Тампико
MMTN => Tamuin Тамуин
MMTO => Lukapa 
MMTO => Toluca 
MMTP => Tapachula Тапашула
MMTU => Tulum Тулум
MMUN => Cancun Канкун
MMVA => Villahermosa Вийяхермоса
MMVR => Veracruz Веракруз
MMZC => Zacatecas Закатекас
MMZH => Ixtapa/Zihuatanejo Ихтапа-Сихуатанех
MMZM => Zamora Замора
MMZO => Manzanillo Манзанилло
MNBL => Bluefields Блуфилдс
MNBZ => Bonanza Бонанса
MNCI => Corn Island Корн-Айленд
MNMG => Managua 
MNPC => Puerto Cabezas Пуэрто-Кабесас
MNSI => Siuna Сиуна
MNWP => Waspam 
MPBO => Bocas Del Toro 
MPCE => Chitre 
MPCH => Changuinola Чангвинола
MPDA => David Давид
MPEJ => Colon Колон
MPHO => Balboa Балбоа
MPJE => Jaque Жак
MPLB => Sabzevar 
MPLP => La Palma Ля Пальма
MPMG => Panama City Панама Сити
MPOA => Puerto Obaldia Пуэрто-Обалдиа
MPSA => Santiago Сантьяго
MPTO => Panama City Панама Сити
MPVR => El Porvenir Эль-Порвенир
MPWN => San Blas Сан-Блас
MRAN => Fortuna 
MRBA => Buenos Aires Буэнос-Айрес
MRBC => Barra Colorado Барра-Колорадо
MRBT => Tortuquero Тортукеро
MRCC => Coto 47 Кото-47
MRCR => Carrillo Каррилльо
MRGF => Golfito Голфито
MRGP => Guapiles Гуапайлз
MRIA => Punta Islita 
MRLB => Liberia Либерия
MRLC => Los Chiles Лос-Чилес
MRLM => Limon Лимон
MRNC => Nicoya Никоя
MRNS => Nosara Beach Носара-Бич
MROC => San Josй 
MRPJ => Puerto Jimenez Пуэрто-Хименес
MRPM => Palmar Палмар
MRQP => Pavones 
MRRF => Rio Frio Рио-Фрио
MRSR => Playa Samara Плайя Самара
MRSV => San Vito 
MRTM => Santa Cruz Санта-Круз-Айленд
MRTM => Tamarindo Тамариндо
MRTR => Tambor Тамбор
MRUP => Upala Упала
MSLP => San Salvador Сан-Сальвадор
MTCA => Les Cayes Лес-Кейес
MTCH => Cap Haitien Кеп-Гаитиен
MTJA => Jacmel 
MTJE => Jeremie Жереми
MTPP => Fort Devens 
MTPP => Ayolas 
MTPP => Port Au Prince 
MTPX => Port De Paix 
MUBA => Baracoa Баракоа
MUBY => Bayamo Байамо
MUCA => Ciego De Avila 
MUCF => Cienfuegos Сиенфуэгос
MUCL => Cayo Largo Del Sur Кайо Ларго Дель Сур
MUCL => Vallejo Валледжо, шт. Калифорния
MUCM => Camaguey Камагуэй
MUCU => Santiago Сантьяго
MUGM => Guantanamo Гуантанамо
MUGT => Guantanamo Гуантанамо
MUHA => Havana Гавана
MUHG => Holguin Голгуин
MULM => La Coloma Ла-Колома
MUMA => Punta De Maisi 
MUMJ => Mayajigua 
MUMO => Moa Моа
MUMZ => Manzanillo Манзанилло
MUNC => Nicaro Никаро
MUNG => Nueva Gerona Нуэва-Герона
MUOC => Cayo Coco Кайо Коко
MUOC => Tampa Тампа
MUPA => Punta Alegre Пунта-Алегре
MUSC => Santa Clara Санта-Клара
MUSJ => San Julian Сан-Хулиан
MUSS => Sancti Spiritus Санкти-Спиритус
MUTD => Trinidad Тринидад
MUVR => Varadero Варадеро
MUVT => Las Tunas Лас-Тунас
MWCB => Cayman Brac Is 
MWCL => Little Cayman 
MWCR => Georgetown 
MYAB => Mangrove Cay Менгров-Кэй
MYAF => Andros Town 
MYAK => Congo Town Конго-Таун
MYAM => Marsh Harbour 
MYAN => San Andros 
MYAP => Spring Point 
MYAT => Treasure Cay, Ibaco Islands 
MYBC => Chub Cay 
MYBG => Great Harbour 
MYBS => Bimini 
MYCB => Cat Island Кэт-Айленд
MYCC => Cat Cays 
MYCI => Crooked Island 
MYCP => Pitts Town Питтс-Таун
MYEC => Cape Eleuthera Кейп-Элутера
MYEF => George Town 
MYEH => North Eleuthera 
MYEM => Governors Harbour 
MYER => Rock Sound 
MYES => Staniel Cay Станиэл-Кэй
MYGD => Deparizo 
MYGM => Grand Bahama 
MYGW => West End Вест-Энд
MYIG => Inagua 
MYLD => Long Island Лонг Айленд
MYLS => Stella Maris 
MYMM => Mayaguana 
MYNN => Nassau 
MYPI => Nassau 
MYRD => Duncan Town 
MYRP => Rum Cay Рум-Кэй
MYSM => San Salvador Сан-Сальвадор
MZBZ => Belize City 
NCAI => Aitutaki Аитутаки
NCAT => Atiu Island 
NCMG => Mangaia Island 
NCMH => Manihiki Island Манихики-Айленд
NCMK => Mauke Island 
NCMR => Mitiaro Island 
NCPY => Penrhyn Island Пенрин-Айленд
NCRG => Rarotonga 
NFCI => Cicia Кикия
NFCS => Castaway Кастэвей
NFFA => Ba Ба
NFFN => Nadi Фиджи-Нади
NFFO => Malololailai Малололайлай
NFFR => Rabi Раби
NFKD => Kandavu Кандаву
NFMA => Mana Island Остров Мана
NFMO => Moala Моала
NFNA => Suva Сува
NFNB => Bureta Бюрета
NFND => Pacific Harbor 
NFNG => Ngau Island 
NFNH => Laucala Is 
NFNK => Lakeba Лакеба
NFNL => Labasa Лабаса
NFNM => Taveuni Тавеуни
NFNO => Koro Island 
NFNR => Rotuma Island 
NFNS => Savusavu Савусаву
NFNU => Bua Буа
NFNV => Vatukoula Ватукула
NFNW => Wakaya Island Вакая-Айленд
NFOL => Ono I Lau Оно-И-Лау
NFSW => Yasawa Island 
NFTE => Eua Эуа
NFTP => Niuatoputapu Ниуатопутапу
NFTV => Vieste Виесте
NFUL => Turtle Island Тертл-Айленд
NFVB => Vanuabalavu Вануабалаву
NFVL => Vatulele Ватулеле
NGAB => Abaiang Абайянг
NGBR => Beru Беру
NGFU => Funafuti Atol 
NGKT => Kuria Куриа
NGMA => Maiana Миайана
NGMK => Marakei Маракеи
NGMN => Makin Island 
NGNU => Nikunau Никунау
NGON => Onotoa Онотоа
NGTA => Tarawa Тарава
NGTB => Abemama Atoll Абемама-Атолл
NGTE => Tabiteuea North Табитуа-Норт
NGTM => Tamana Island 
NGTO => Rotima 
NGTR => Arorae Island Ароре-Айленд
NGTS => Tabiteuea South Табитуа-Сауз
NGTU => Butaritari Бутаритари
NGUK => Aranuka Аранука
NIUE => Niue Island Ниуе-Айленд
NLWF => Futuna Island Футуна-Айленд
NLWW => Wallis Island 
NSAS => Ofu 
NSAU => Asau Асау
NSFA => Apia 
NSFI => Apia 
NSFQ => Freida River 
NSFQ => Fitiuta Фитута
NSMA => Maota Savaii Is 
NSTU => Pago Pago 
NTAA => Beaver Inlet 
NTAA => Puerto Leda 
NTAA => Papeete 
NTAR => Rurutu 
NTAT => Tubuai 
NTGA => Anaa Анаа
NTGB => Fangatau Фангатау
NTGC => Tikehau Atoll Тикехау-Атолл
NTGD => Apataki 
NTGE => Reao 
NTGF => Fakarava 
NTGH => Hikueru Хикуэру
NTGI => Manihi Манихи
NTGJ => Gambier Is 
NTGK => Kaukura Atoll 
NTGM => Makemo Макемо
NTGN => Napuka Island 
NTGO => Tatakoto Татакото
NTGP => Puka Puka 
NTGQ => Pukarua 
NTGT => Takapoto Такапото
NTGU => Arutua 
NTGV => Mataiva Матайва
NTGW => Nukutavake 
NTGY => Tureira 
NTHE => Ahe 
NTKA => Kauehi 
NTKF => Faaite 
NTKH => Fakahina Факахина
NTKR => Takaroa Такароа
NTMD => Nuku Hiva 
NTMN => Atuona 
NTMN => Hiva Oa 
NTMP => Ua Pou 
NTMU => Ua Huka 
NTTB => Bora Bora 
NTTE => Tetiaroa Is 
NTTG => Rangiroa 
NTTH => Huahine 
NTTM => Moorea 
NTTO => Hao Island Хао-Айленд
NTTP => Maupiti 
NTTR => Raiatea 
NTUV => Vahitahi Вахитахи
NVSA => Mota Lava Мота-Лава
NVSC => Sola Сола
NVSD => Torres Торрес
NVSE => Emae Эмей
NVSF => Craig Cove Крейг-Кав
NVSG => Longana Лонгана
NVSH => Sara Сара
NVSI => Paama Паама
NVSL => Lamap Ламап
NVSM => El Palomar 
NVSM => Lamen Bay Ламен-Бей
NVSN => Maewo Мево
NVSO => Lonorore 
NVSP => Norsup Норсуп
NVSQ => Gaua 
NVSR => Redcliffe Редклифф
NVSS => Espiritu Santo 
NVST => Tongoa Тонгоа
NVSU => Ulei Улей
NVSV => Valesdir Вейлсдир
NVSW => Walaha Валаха
NVSX => South West Bay Сауз-Вест-Бей
NVSZ => Olpoi Олпой
NVVA => Aneityum Анейтьюм
NVVB => Aniwa Анива
NVVD => Dillons Bay Диллонс-Бей
NVVF => Futuna Island Футуна-Айленд
NVVI => Ipota Ипота
NVVQ => Quine Hill Кин-Хилл
NVVV => Port Vila Порт Вила
NVVW => Tanna 
NWWA => Tiga Тига
NWWC => Belep Island 
NWWD => Kone Коне
NWWE => Ile Des Pins 
NWWH => Houailou 
NWWK => Koumac Кумак
NWWL => Lifou 
NWWM => Noumea 
NWWO => Ile Ouen 
NWWP => Poum 
NWWQ => Mueo Муэо
NWWR => Mare 
NWWU => Touho Туо
NWWV => Ouvea 
NWWW => Noumea 
NZAA => Auckland Окленд
NZAP => Taupo Таупо
NZAR => Ardmore Ардмор
NZAS => Ashburton Ашбертон
NZCH => Christchurch Кристчерч
NZCI => Chatham Island Чатам-Айленд
NZCI => Isabel Pass 
NZCX => Coromandel Коромандель
NZDA => Dargaville Даргавиль
NZDN => Dunedin Дунедин
NZFH => Fox Glacier Фокс Гласиер
NZFJ => Franz Josef Франц-Джозеф
NZGB => Great Barrier Island Грейт-Барьер-Айленд
NZGM => Greymouth Греймауз
NZGS => Gisborne Гизборн
NZGT => Mount Cook Маунт Кук
NZHK => Hokitika Хокитика
NZHN => Hamilton Гамильтон
NZKE => Surfdale Сурфдейл
NZKI => Kaikoura Каикоура
NZKK => Kerikeri 
NZKO => Kaikohe Кайкоэ
NZKT => Kaitaia Кайтайа
NZLX => Alexandra Александра
NZMA => Matamata Матамата
NZMB => Auckland Окленд
NZMC => Mount Cook Маунт Кук
NZMF => Milford Sound Милфорд Саунд
NZMK => Motueka Мотуэка
NZMO => Te Anau Те Анау
NZMS => Masterton Мастертон
NZNP => New Plymouth Нью-Плимут
NZNR => Napier-Hastings Напье-Хастингс
NZNS => Nelson Нельсон
NZNV => Invercargill Инверкаргилл
NZOH => Ohakea 
NZOU => Oamaru Оамару
NZPM => Palmerston North Палмерстон Норт
NZPN => Picton Пиктон
NZPP => Paraparaumu Парапарауму
NZQN => Queenstown Куинстаун
NZRA => Raglan 
NZRC => Stewart Island Стюарт-Айленд
NZRO => Rotorua Роторуа
NZSP => Glendale 
NZSP => Samarai Island 
NZTG => Tauranga Тауранга
NZTH => Thames 
NZTK => Takaka Такака
NZTL => Teixeira de Freitas 
NZTO => Tokoroa 
NZTS => Taharoa Тахароа
NZTU => Timaru Тимару
NZWA => Waitangi Вайтанги
NZWB => Blenheim Бленхайм
NZWF => Wanaka Ванака
NZWK => Whakatane Вакатане
NZWN => Wellington Уеллингтон
NZWO => Wairoa 
NZWR => Whangarei Вангарей
NZWS => Westport Вестпорт
NZWT => Whitianga 
NZWU => Wanganui Вангануи
OABN => Bamiyan Бамиан
OABT => Bost Бост
OACC => Chakcharan Чагчаран
OADS => Sardeh Band Сардех-Банд
OADZ => Darwaz Дарваз
OAFR => Farah Фарах
OAFZ => Faizabad Файзабад
OAGN => Ghazni Газни
OAGZ => Gardez Гардез
OAHN => Khwahan Хвахан
OAHR => Herat Герат
OAJL => Jalalabad Джелалабад
OAKB => Kabul 
OAKB => Kapal 
OAKN => Kandahar Кандагар
OAKS => Khost Хост
OAMN => Maimana Меймене
OAMS => Mazar-i-sharif 
OAOG => Urgoon Ургун
OAQN => Qala Nau 
OARG => Uruzgan Урузган
OARZ => Kuran-O-Munjan 
OASN => Sheghnan 
OATN => Tirinkot Таринкот
OATQ => Taluqan Талукан
OATW => Tetlin 
OAUZ => Kunduz Кундуз
OAZB => Rennes Ренн
OAZB => Bordeaux Бордо
OAZJ => Zaranj Зарандж
OBBI => Manama 
ODAL => Dhala Дала
OEAB => Abha Абха
OEAH => Alahsa 
OEBA => Al-Baha 
OEBH => Bisha Биша
OEDF => Port Frederick 
OEDR => Dhahran Дхахран
OEDW => Dawadmi 
OEGN => Jazan 
OEGN => Incheon Инчеон
OEGS => Buraidah 
OEGT => Gurayat Гураят
OEHL => Hail Хаиль
OEJN => Jeddah Джедда
OEJN => Jatai 
OEJN => Thousand Oaks Таузэнд Оукс
OEKK => King Khalid Mil. City 
OEKM => Khamis Mushait 
OEMA => Madinah 
OENG => Nejran Неджран
OEPA => Qaisumah Кайсумах
OEPS => Al Kharj 
OERF => Rafha Рафха
OERK => Rotunda 
OERK => Riyadh Халлсберг
OERR => Arar Арар
OESH => Sharurah Шарура
OESK => Sakaka Al Jouf 
OESL => Sulayel Сулаель
OETB => Tabuk Табук
OETF => Taif Таиф
OETR => Turaif Тураиф
OEWD => Wadi Ad Dawasir Вади-ад-Давасир
OEWJ => Wedjh Ведих
OEYN => Yanbu Янбу
OEZL => Zilfi Зилфи
OIAA => Abadan Абадан
OIAM => Bandar Mahshahr 
OIAW => Ahwaz Ахваз
OIBB => Bushehr Бушехр
OIBH => Bahregan Бахреган
OIBJ => Kangan Канган
OIBK => Kish Island Киш-Айленд
OIBL => Bandar Lengeh Бандар-Ленге
OIBQ => Khark Island 
OIBS => Sirri Island Сирри-Айленд
OIBV => Lavan 
OICC => Kermanshah Керманшах
OICK => Khorramabad 
OICS => Sanandaj Санандадж
OIFM => Isfahan Исфахан
OIFS => Shahre-kord 
OIGG => Rasht Рашт
OIHH => Hamadan Хамадан
OIHR => Neptune, NJ 
OIII => Tehran Техран
OIKB => Bandar Abbas Бандар-Аббас
OIKK => Kerman Керман
OIKM => Bam 
OIKR => Rafsanjan 
OIMB => Birjand Бирджанд
OIMM => Mashad Машад
OIMN => Bojnord 
OIMT => Tabas 
OINB => Babolsar Баболсар
OINJ => Bishe-kola 
OINN => Now Shahr 
OINR => Ramsar Рамсар
OINZ => Star Habour 
OINZ => Sary Сари
OISJ => Jahrom 
OISL => Lar 
OISS => Shiraz Шираз
OITL => Ardabil 
OITM => Sahand 
OITR => Urmieh Урмиех
OITT => Tabriz Табриз
OIYY => Yazd Язд
OIZB => Zabol Забол
OIZC => Chah-Bahar 
OIZH => Zahedan Захедан
OIZH => Philadelphia Филадельфия
OIZJ => San Rafael Сан-Рафаэль
OJAI => Amman Амман
OJAM => Amman Амман
OJAQ => Aqaba Акаба
OJJR => Jerusalem Иерусалим
OJMF => Mafraq 
OJMN => Maan Маан
OKBK => Kandy Канди
OKBK => Kuwait City 
OLBA => Beirut Бейрут
OLKA => Tripoli Триполи
OMAA => Abu Dhabi Абу-Даби
OMAA => Abu Dhabi Абу-Даби
OMAA => La Palma Del Condado 
OMAC => Mexico City Мексико Сити
OMAD => Abu Dhabi Абу-Даби
OMAL => Al Ain Аль-Айн
OMDB => Dambula 
OMDB => Dayton 
OMDB => Dubai Дубай
OMDM => Minhad AB 
OMFJ => Fuengirola Фенгерола
OMFJ => Al-fujairah 
OMRK => Ras Al Khaimah Рас-аль-Хайма
OMSJ => Sharjah Шарджа
OMUQ => Umnak Island 
OOBR => Buraimi Бурайми
OOFD => Sui Fen He 
OOGB => Giebelstadt 
OOKB => Khasab Хасаб
OOMA => Masirah Масирах
OOMS => Muscat Мускат
OOMS => Seal Bay 
OONR => Marmul Мармул
OONZ => South Weymouth 
OOSA => Salalah Салала
OOSR => Sur Сур
OOTH => Thumrait Тумрайт
OPBN => Bannu Банну
OPBR => Bahawalnagar Бахавалнагар
OPBW => Bahawalpur Бахавалпур
OPCH => Chitral Читрал
OPCL => Chilas Чилас
OPDB => Dalbandin Далбандин
OPDD => Dadu Даду
OPDG => Dera Ghazi Khan 
OPDI => Dera Ismail Khan Дера-Исмаил-Хан
OPFA => Faisalabad Фейсалабад
OPGD => Gwadar Гвадар
OPGT => Gilgit Гилгит
OPJA => Jacobabad Джакобабад
OPJI => Jiwani Дживани
OPKC => Karachi 
OPKD => Hyderabad Хидерабад
OPKH => Khuzdar Хуздар
OPKL => Kalat Калат
OPKT => Kohat Кохат
OPLA => Lahore Лахор
OPMF => Muzaffarabad Музаффарабад
OPMI => Mianwali Мьанвали
OPMJ => Mohenjodaro 
OPMP => Mirpur Khas Мирпур-Хас
OPMT => Multan Мултан
OPNH => Nawabshah 
OPNK => Nushki Нушки
OPOR => Ormara Ормара
OPPC => Para Chinar Пара-Чинар
OPPG => Panjgur Панджгур
OPPI => Pasni Пасни
OPPS => Peshawar Пешавар
OPQT => Quetta Кветта
OPRK => Rahim Yar Khan Рахим-Яр-Хан
OPRN => Islamabad 
OPRT => Rawala Kot Равала-Кот
OPSB => Sibi Сиби
OPSD => Skardu Скарду
OPSK => Sukkur Суккур
OPSP => Shikarpur 
OPSR => Sargodha Саргодха
OPSS => Saidu Sharif Саиду-Шариф
OPST => Sialkot Сиалкот
OPSU => Sui Суи
OPSW => Sahiwal Сахивал
OPTA => Tarbela Тарбела
OPTH => Badin Бадин
OPTT => Taftan Тафтан
OPTU => Turbat Турбат
OPWN => Wana Вана
OPZB => Zhob Зхоб
OPZB => Vail/Eagle 
OPZB => Aruja 
OPZB => Inverness 
OPZB => New Haven 
OPZB => Hampton 
OPZB => SNCB Rail Network 
OPZB => Faro Фаро
ORBB => Bamerny Бамерни
ORBI => Baghdad Багдад
ORBI => Baghdad Багдад
ORBM => Mosul Мосул
ORKK => Kirkuk Киркук
ORMM => Basra 
ORQW => Ikerasaarsuk 
OSAP => Aleppo Алеппо
OSDI => Damascus Дамаск
OSDZ => Deirezzor 
OSKL => Kameshli Камешли
OSLK => Latakia Латакия
OSPR => Palmyra Пальмира
OTBD => Doha Доха
OYAA => Aden Аден
OYAB => Abbse Аббсе
OYAT => Ataq Атак
OYBI => Beidah Бейда
OYBN => Beihan Бейхан
OYBQ => Albuq Альбук
OYGD => Al Ghaydah Аль-Гайда
OYHD => Hodeidah 
OYKM => Kamaran Is 
OYMB => Mareb Мариб
OYMK => Mukeiras Мукейрас
OYMO => Mukalla Мукалла
OYQN => Qishn Кишн
OYRN => Riyan Mukalla 
OYSH => Sadah Сада
OYSQ => Socotra Сокотра
OYSY => Seiyun Сейюн
OYTZ => Taiz 
PAAK => Atka 
PAAP => Port Alexander 
PAAQ => Palmer 
PAAT => Attu Island 
PABE => Bethel 
PABG => Beluga 
PABI => Big Delta 
PABL => Buckland 
PABM => Big Mountain 
PABR => Barrow 
PABR => Brazoria 
PABT => Bettles 
PABU => Barter Island 
PABV => Belmopan 
PACA => Cape Spencer 
PACD => Cold Bay 
PACE => Central 
PACH => Chuathbaluk 
PACI => Chalkyitsik 
PACK => Chefornak, AK 
PACK => Chefornak 
PACM => Scammon Bay 
PACR => Circle 
PACV => Cordova 
PACX => Coldfoot 
PACY => Yakataga 
PACZ => Cape Romanzof 
PADE => Deering 
PADG => Daugo 
PADG => Red Dog 
PADK => Adak Island 
PADL => Dillingham 
PADQ => Kodiak 
PADU => Dutch Harbor 
PADY => Kongiganak 
PAED => Anchorage Анкораж
PAEE => Eek 
PAEG => Eagle 
PAEH => Cape Newenham 
PAEI => Fairbanks 
PAEL => Elfin Cove 
PAEM => Emmonak 
PAEN => Kenai 
PAEW => Newtok 
PAFA => Fairbanks 
PAFB => Fairbanks 
PAFE => Kake 
PAFM => Ambler 
PAFR => Fort Richardson 
PAFS => Nikolai 
PAFV => Five Mile 
PAFW => Farewell 
PAGA => Galena 
PAGB => Galbraith Lake 
PAGH => Shungnak 
PAGK => Gulkana 
PAGL => Golovin 
PAGM => Gambell 
PAGN => Angoon 
PAGQ => Big Lake 
PAGS => Gustavus 
PAGT => Nightmute 
PAGY => Skagway 
PAHC => Holy Cross 
PAHE => Tahneta Pass Lodge 
PAHL => Huslia 
PAHN => Haines 
PAHO => Homer 
PAHP => Hooper Bay 
PAHU => Hughes 
PAHV => Healy Lake 
PAHX => Shageluk 
PAHY => Hydaburg 
PAIG => Igiugig 
PAII => Egegik 
PAIK => Kiana 
PAIL => Iliamna 
PAIM => Utopia Creek 
PAIN => Sault Ste Marie Со Сен Мари
PAIN => Mt Mckinley 
PAIW => Wales Уэльс
PAJC => Chignik 
PAJC => Chignik 
PAJN => Juneau 
PAJZ => New Koliganek 
PAKD => Kodiak 
PAKF => False Pass 
PAKH => Akhiok 
PAKI => Kipnuk 
PAKK => Koyuk 
PAKL => Kulik Lake 
PAKN => King Salmon 
PAKO => Nikolski 
PAKP => Anaktuvuk 
PAKT => Ketchikan 
PAKU => Kuparuk 
PAKV => Kaltag 
PAKW => Aghajari 
PAKW => Klawock 
PAKY => Karluk 
PALB => Larsen Bay 
PALG => Kalskag 
PALJ => Port Alsworth 
PALJ => Tanalian Point 
PALN => Lonely 
PALR => Chandalar 
PALU => Cape Lisburne 
PAMB => Manokotak 
PAMC => Mcgrath 
PAMD => Middleton Island 
PAMH => Minchumina 
PAMK => St Michael 
PAML => Manley Hot Springs 
PAMM => Metlakatla 
PAMO => Mountain Village 
PAMR => Anchorage Анкораж
PAMX => Mccarthy 
PAMY => Mekoryuk 
PANA => Napakiak 
PANC => Anchorage Анкораж
PANI => Aniak 
PANN => Nenana 
PANO => Nondalton 
PANR => Funter Bay 
PANT => Annette Island 
PANU => Nulato 
PANV => Anvik 
PANW => New Stuyahok 
PAOB => Kobuk 
PAOC => Portage Creek 
PAOH => Hoonah 
PAOM => Nome 
PAOO => Toksook Bay 
PAOR => Northway 
PAOT => Kotzebue 
PAOU => Nelson Lagoon 
PAPB => Porto Dos Gauchos 
PAPB => St George Island 
PAPC => Port Clarence 
PAPE => Perryville 
PAPG => Petersburg, AK 
PAPH => Port Heiden 
PAPK => Napaskiak 
PAPM => Platinum 
PAPN => Pilot Point 
PAPO => Point Hope 
PAPR => Prospect Creek 
PAQH => Quinhagak 
PAQT => Nuiqsut 
PARC => Arctic Village 
PARS => Russian Mission 
PARY => Ruby 
PASA => Savoonga 
PASC => Prudhoe Bay/Deadhorse 
PASD => Sand Point 
PASH => Shishmaref 
PASI => Sitka 
PASK => Selawik 
PASL => Sleetmute 
PASM => Saint Marys 
PASN => Saint Paul Island 
PASO => Seldovia 
PASP => Sheep Mountain 
PAST => Summit 
PASV => Sparrevohn 
PASW => Skwentna 
PASX => Soldotna 
PASY => Shemya 
PATA => Tanana Танана
PATC => Tin City, AK 
PATE => Teller 
PATG => Togiak Village 
PATJ => Tok 
PATK => Talkeetna 
PATL => Tatalina Таталина
PATQ => Atqasuk 
PAUK => Alakanuk 
PAUM => Umiat 
PAUN => Unalakleet 
PAUO => Willow 
PAVA => Chevak 
PAVC => King Cove 
PAVD => Valdez 
PAVE => Venetie 
PAVL => Kivalina 
PAWB => Beaver 
PAWD => Seward 
PAWG => Wrangell 
PAWI => Wainwright 
PAWM => White Mountain 
PAWN => Noatak 
PAWS => Wasilla 
PAYA => Yakutat 
PCIS => Canton Island Кентон-Айленд
PFAK => Akiak 
PFAL => Allakaket 
PFCL => Clarks Point 
PFEL => Elim 
PFKA => Kasigluk 
PFKO => Kotlik 
PFKT => Teller Mission 
PFKU => Koyukuk 
PFKW => Kwethluk 
PFSH => Shaktoolik 
PFWS => South Naknek 
PFYU => Fort Yukon 
PGRO => Rota Рота
PGUA => Andersen, Mariana Island 
PGUM => Dongguan 
PGWT => Tinian 
PHBK => Kekaha 
PHDH => Oahu 
PHHI => Wahiawa 
PHHN => Hana 
PHIK => Honolulu Гонолулу
PHJH => Lahaina, HI 
PHJR => Barbers Point 
PHKO => Amchitka Ам-Тиман
PHKO => Kona 
PHLI => Caprivi 
PHLI => Kauai Island 
PHLU => Kalaupapa 
PHMK => Hoolehua 
PHMU => Kamuela 
PHNL => Honolulu Гонолулу
PHNL => Ourilandia 
PHNY => Lanai City 
PHOG => Maui 
PHSF => Pohakuloa 
PHTO => Hilo 
PHUP => Upolu Point 
PJON => Johnston Island 
PKMA => Enewetak Island 
PKMJ => Majuro 
PKWA => Anita Bay 
PKWA => Eight Fathom Bight 
PKWA => Eisenach Айзенах
PKWA => Kwajalein 
PLCH => Christmas Island 
PLFA => Tabuaeran 
PMDY => Midway Island 
POLI => Olafsvik Олафсвик
PPIZ => Point Lay 
PTKK => Truk 
PTPN => Pohnpei Понпеи
PTRO => Koror 
PTSA => Kosrae 
PTYA => Yap, Caroline Islands 
PWAK => Wake Island 
RCBS => Kinmen Кинмень
RCCM => Chi Mei 
RCFG => Nangan 
RCFN => Taitung Тайтунг
RCGI => Green Island Грин Айленд
RCKH => Kaohsiung 
RCKU => Chiayi Чиайи
RCKW => Hengchun 
RCLG => Taichung Тайчунг
RCLS => Lishan Лишань
RCLY => Orchid Island Орхид-Айленд
RCMQ => Taichung Тайчунг
RCNN => Tainan Тайнань
RCQC => Makung Макунг
RCSQ => Pingtung 
RCSS => Taipei 
RCTP => Kugururok River 
RCTP => Tifalmin 
RCTP => Taipei 
RCWA => Wonan Вонань
RCYU => Hualien Хуалянь
RJAA => Tokyo Токио
RJAA => Tangara da Serra Тангара де Серра
RJAF => Matsumoto Матсумото
RJAW => Iwo Jima Vol 
RJBB => Osaka Осака
RJBD => Shirahama Ширахама
RJBE => Kobe Кобе
RJBH => Hiroshima Хиросима
RJBT => Toyooka 
RJCB => Obihiro Обихиро
RJCC => Cadiz Кадиз
RJCC => Sapporo Саппоро
RJCH => Hakodate Хакодате
RJCK => Kushiro Куширо
RJCM => Memanbetsu Меманбецу
RJCN => Nakashibetsu Накасибецу
RJCO => Sapporo Саппоро
RJCR => Rebun Ребун
RJCW => Wakkanai 
RJDB => Iki Ики
RJDC => Ube Убе
RJDT => Tsushima Цусима
RJEB => Monbetsu Монбецу
RJEC => Asahikawa Асахикава
RJEO => Okushiri Окусири
RJER => Rishiri Рисири
RJFC => Yakushima 
RJFE => Fukue Фуку
RJFF => Fukuoka Фукуока
RJFF => Kizhuyak 
RJFG => Tanegashima Танегасима
RJFK => Kagoshima Кагошима
RJFM => Miyazaki Миядзаки
RJFO => Oita Оита
RJFR => Crane Island 
RJFR => Kita Kyushu Кита-Кюсю
RJFS => Saga 
RJFT => Kumamoto Кумамото
RJFU => Nagasaki Нагасаки
RJKA => Amami O Shima Амами-О-Сима
RJKB => Okino Erabu Окино-Эрабу
RJKI => Kikaiga Shima Кикаига-Сима
RJKN => Tokunoshima 
RJNA => Nagoya Нагойя
RJNF => Fukui Фукуи
RJNK => Komatsu Коматсу
RJNO => Oki Island Оки-Айленд
RJNT => Toyama Тояма
RJNW => Wajima 
RJOA => Hiroshima Хиросима
RJOB => Okayama Окаяма
RJOC => Izumo Идзумо
RJOH => Yonago Йонаго
RJOK => Kochi Кочи
RJOM => Matsuyama Мацуяма
RJOO => Osaka Осака
RJOR => Tottori Тоттори
RJOS => Tokushima Токушима
RJOT => Takamatsu Такаматсу
RJOW => Iwami Ивами
RJSA => Aomori Аомори
RJSC => Yamagata Ямагата
RJSD => Sado Shima Садо-Сима
RJSF => Fukushima Фукушима
RJSH => Hachinohe Хачинохе
RJSI => Hanamaki 
RJSK => Akita Акита
RJSM => Misawa Мисава
RJSN => Niigata Ниигата
RJSR => Odate Noshiro 
RJSS => Sendai Сендай
RJSY => Shonai Сонай
RJTA => Atsugi Ацуги
RJTH => Hachijo Jima 
RJTO => Oshima 
RJTQ => Miyake Jima Мияке-Жима
RJTT => Tokyo Токио
RJTU => Ankokoambo 
RJTY => Tokyo Токио
RKJJ => Gwangju Гванджу
RKJK => Gunsan 
RKJM => Mokpo Мокпо
RKJU => Jeonju Джеонжу
RKJY => Yeosu 
RKND => Sokcho Сокчо
RKNN => Gangneung Гангнеунг
RKNS => Samcheok 
RKNW => WonJu 
RKNY => Yangyang Янян
RKPC => Jeju 
RKPC => Kuyol 
RKPE => Jinhae 
RKPK => Busan 
RKPS => Jinju 
RKPU => Ulsan Ульсан
RKSI => Seoul Сеул
RKSO => Osan 
RKSW => Suwon Суон
RKTH => Pohang Пхохан
RKTN => Daegu Даегу
RKTU => Cheongju 
RKTY => Yecheon 
ROAH => Okinawa Окинава
RODN => Okinawa Окинава
ROIG => Ishigaki Исигаки
ROKJ => Kumejima 
ROKR => Kerama Керама
ROMD => Minami Daito 
ROMY => Miyako Jima 
RORA => Aguni Агуни
RORE => Iejima Иежима
RORG => Okinawa Окинава
RORH => Hateruma Хатерума
RORK => Kitadaito 
RORS => Shimojishima Симожисима
RORT => Taramajima Тарамажима
RORY => Yoronjima 
ROYN => Yonaguni Jima Йонагуни-Жима
RPLC => Angeles City 
RPLI => Laoag Лаоак
RPLL => Manila 
RPLO => Cuyo 
RPLO => Kamusi Кугурурок-Ривер, шт. Аляска
RPLP => Legazpi 
RPLS => Sangley Point Сангли-Пойнт
RPLU => Lubang 
RPMA => Surallah 
RPMB => General Santos Женерал-Сантос
RPMC => Cotabato Котабато
RPMD => Davao 
RPME => Butuan Бутуань
RPMF => Bislig Бислиг
RPMG => Dipolog Диполог
RPMH => Camiguin Камигуин
RPMI => Iligan Илиган
RPMJ => Jolo Жоло
RPML => Cagayan De Oro Кагаян Де Оро
RPMM => Malabang Малабанг
RPMN => Sanga Sanga Санга-Санга
RPMO => Ozamis City Озамис-Сити
RPMP => Pagadian Пагадиан
RPMQ => Mati Мати
RPMS => Surigao Суригао
RPMU => Cagayan De Sulu 
RPMV => Ipil Ипил
RPMW => Tandag Тандаг
RPMZ => Zamboanga 
RPNO => Siocon 
RPUB => Baguio Багуйо
RPUD => Daet Дает
RPUH => San Jose Сан-Хосе
RPUM => Mamburao Мамбурао
RPUN => Naga Нага
RPUO => Basco Баско
RPUR => Baler Балер
RPUS => San Fernando Сан Фернандо
RPUT => Tuguegarao Тугуэгарао
RPUV => Virac Вирак
RPUW => Marinduque Мариндюк
RPUY => Cauayan Кауаян
RPUZ => Baganga 
RPVA => Tacloban 
RPVB => Bacolod Баколод
RPVC => Calbayog Калбайог
RPVD => Dumaguete Думагете
RPVE => Caticlan 
RPVF => Catarman Катарман
RPVI => Iloilo Йоило
RPVJ => Masbate Масбате
RPVK => Kalibo Калибо
RPVM => Cebu Кебу
RPVO => Ormoc Ормок
RPVP => Puerto Princesa 
RPVR => Roxas City Рохас Сити
RPVS => Antique 
RPVT => Tagbilaran Тагбиларан
RPVU => Tablas Таблас
RPVV => Busuanga Корон
RPVV => Coron 
SAAC => Concordia 
SAAG => Gualeguaychu Гуалегуайчу
SAAJ => Junin Хунин
SAAP => Parana 
SAAR => Rosario Росарио
SAAV => Santa Fe Санта Фе
SAAV => Sundance 
SABE => Buenos Aires Буэнос-Айрес
SACC => La Cumbre 
SACO => Cordoba Кордова
SADL => La Plata 
SAEZ => Buenos Aires Буэнос-Айрес
SAHC => Chos Malal 
SAHE => Caviahue Кавиахуэ
SAHR => General Roca Хенераль-Рока
SAHS => Rincon de los Sauces 
SAHZ => Zapala Запала
SAME => Mendoza Мендоса
SAMM => Malargue Маларкуэ
SAMR => San Rafael Сан-Рафаэль
SANC => Catamarca Катамарка
SANE => Santiago Del Estero 
SANH => Rio Hondo Рио Хондо
SANL => La Rioja Ла-Риоха
SANT => Tucuman Тукуман
SANU => San Juan Сан Хуан
SANW => Ceres Керес
SAOC => Rio Cuarto 
SAOD => Villa Dolores Вилья-Долорес
SAOR => Villa Mercedes Вилья-Мерседес
SAOU => San Luis Сан-Луис
SARC => Corrientes Корриентес
SARE => Resistencia Ресистенсия
SARF => Formosa Формоса
SARF => Picayune 
SARI => Iguazu 
SARL => Paso De Los Libres 
SARM => Monte Caseros 
SARP => Posadas Посадас
SARS => Pres. Roque Saenz Pena 
SASA => Salta Сальта
SASJ => Jujuy Хухуй
SASO => Oran Оран
SASQ => Akunnaaq 
SASQ => Attu 
SASQ => Kitsissuarsuit 
SASQ => Ikamiut 
SAST => Tartagal Тартагал
SATC => Clorinda Клоринда
SATD => Eldorado Эльдорадо
SATG => Goya Гоя
SATK => Las Lomitas Лас-Ломитас
SATM => Mercedes Мерседес
SATR => Reconquista Реконкиста
SATU => Curuzu Cuatia Курусу-Куатья
SAVB => El Bolson Эль-Больсон
SAVC => Comodoro Rivadavia 
SAVD => El Maiten Эль-Майтен
SAVE => Esquel Эскель
SAVH => Las Heras Лас-Херас
SAVJ => Ingeniero Jacobacci Инженеро-Джако
SAVJ => Paf Warren 
SAVM => Colonia Sarmiento 
SAVN => San Antonio Oeste 
SAVQ => Maquinchao Макинчао
SAVR => Alto Rio Senguerr Альто-Рио-Сенгерр
SAVS => Sierra Grande Сьерра-Гранде
SAVT => Trelew Трелью
SAVT => Fiumicino 
SAVT => Hartford Хартфорд
SAVT => Boston Бостон
SAVV => Viedma 
SAVY => Puerto Madryn 
SAWA => Lago Argentino 
SAWC => El Calafate 
SAWD => Puerto Deseado Пуэрто-Десеадо
SAWE => Rio Grande Рио-Гранде
SAWG => Rio Gallegos Рио-Гальегос
SAWH => Ushuaia Ушуайа
SAWJ => San Julian Сан-Хулиан
SAWM => Rio Mayo Рио-Майо
SAWP => Perito Moreno Перито-Морено
SAWR => Gobernador Gregores 
SAWS => Jose De San Martin 
SAWT => Rio Turbio Рио-Турбио
SAWU => Santa Cruz Санта-Круз-Айленд
SAZB => Bahia Blanca 
SAZC => Coronel Suarez 
SAZG => General Pico Хенераль-Пико
SAZH => Tres Arroyos Трес-Арройос
SAZL => Santa Teresita Санта-Тересита
SAZM => Mar Del Plata 
SAZN => Neuquen Неукен
SAZO => Necochea Некочеа
SAZP => Pehuajo 
SAZR => Santa Rosa Санта-Роса
SAZS => San Carlos DeBariloche 
SAZT => Tandil Тандиль
SAZV => Taltheilei Narrows 
SAZV => Villa Gesell Вилья-Хесель
SAZW => Cutral 
SAZY => San Martin DeLos Andes 
SBAA => Conceicao Do Araguaia 
SBAQ => Araraquara 
SBAR => Aracaju Аракайю
SBAS => Assis 
SBAT => Alta Floresta Алта-Флореста
SBAU => Aracatuba 
SBAX => Araxa 
SBBE => Belem Белем
SBBG => Bage 
SBBH => Belo Horizonte Бело Хоризонте
SBBR => Brasilia Бразилия
SBBT => Barretos 
SBBU => Bauru 
SBBV => Boa Vista 
SBBW => Barra Do Garcas 
SBBZ => Buzios Бузиос
SBCA => Cascavel 
SBCB => Cabo Frio 
SBCG => Campo Grande Кампо Гранде
SBCH => Creston 
SBCH => Chapeco 
SBCI => Carolina 
SBCJ => Carajas 
SBCM => Criciuma 
SBCP => Campos 
SBCR => Corumba 
SBCT => Curitiba Куритиба
SBCV => Caravelas Каравелас
SBCX => Caxias Do Sul Касьяс ду Суль
SBCY => Cuiaba Куиаба
SBCZ => Cruzeiro Do Sul 
SBDN => Presidente Prudente 
SBEG => Manaus Манаус
SBEK => Jacareacanga 
SBFI => Iguassu Falls 
SBFL => Florianopolis Флорианополис
SBFN => Fernando De Noronha 
SBFZ => Fortaleza Форталеса
SBGL => Rio De Janeiro 
SBGM => Guajara-Mirim 
SBGO => Goiania 
SBGR => Concepcion Консепсьон
SBGR => Crystal Lake 
SBGR => Sao Paulo Сао Паоло
SBGR => Sehwen Sharif 
SBGU => Guarapuava 
SBGV => Governador Valadares 
SBGW => Guaratingueta 
SBHT => Altamira 
SBIC => Itacoatiara 
SBIH => Itaituba 
SBIL => Ilheus Илеус
SBIP => Ipatinga Ипатинга
SBIZ => Imperatriz 
SBJF => Juiz De Fora 
SBJP => Joao Pessoa Жоао Пессоа
SBJU => Juazeiro Do Norte 
SBJV => Joinville 
SBKG => Campina Grande 
SBKP => Campinas, Sao Paulo 
SBLE => Lencois Ленкуа
SBLJ => Lages 
SBLN => Lins 
SBLO => Londrina Лондрина
SBLP => Bom Jesus Da Lapa 
SBMA => Maraba 
SBMC => Minacu Минаку
SBMD => Monte Dourado Монте-Дурадо
SBME => Macae 
SBMG => Maringa 
SBMK => Montes Claros 
SBML => Marilia 
SBMN => Ponta Pelada 
SBMO => Maceio Масейо
SBMO => Zhongshan Чжуншань
SBMO => Newark 
SBMO => Huangpu 
SBMQ => Macapa 
SBMS => Mossoro 
SBMY => Manicore 
SBNF => Navegantes Навегантес
SBNM => Santo Angelo 
SBNT => Natal Наталь
SBOI => Overberg 
SBOI => Oiapoque 
SBPA => Porto Alegre Порто Алегре
SBPB => Parnaiba 
SBPC => Pocos De Caldas 
SBPF => Passo Fundo 
SBPJ => Palmas 
SBPK => Pelotas 
SBPL => Santa Lucia 
SBPL => Nakolik River 
SBPL => Petrolina 
SBPN => Porto Nacional 
SBPP => Ponta Pora 
SBPS => Porto Seguro Порто Сегуро
SBPV => Porto Velho 
SBPV => Tuticorin 
SBPV => San Domino Island 
SBQV => Vitoria Da Conquista 
SBRB => Rio Branco 
SBRF => Cinder River 
SBRF => Recife Ресифе
SBRF => Taytay Sandoval 
SBRG => Rio Grande Рио-Гранде
SBRJ => Rio De Janeiro 
SBRP => Ribeirao Preto 
SBRR => Barreirinhas 
SBSC => Gheshm 
SBSC => Santa Cruz Санта-Круз-Айленд
SBSJ => Sao Jose Dos Campos 
SBSL => Sгo Luis 
SBSM => Santa Maria, Rs 
SBSN => Santarem Сантарем
SBSP => Sao Paulo Сао Паоло
SBSR => Sao Jose Do Rio Preto Сан Хосе Ду Рио Прето
SBST => Santos 
SBSV => Salvador, Bahia 
SBTB => Trombetas 
SBTC => Una 
SBTD => Toledo Толедо
SBTE => Teresina Терезина
SBTF => Tefe Тефе
SBTK => Tarauaca 
SBTL => Telemaco Borba 
SBTT => Tabatinga 
SBTU => Tucurui 
SBUA => Sao Gabriel Сан-Габриэл
SBUF => Paulo Afonso 
SBUG => Uruguaiana 
SBUL => Uberlandia 
SBUP => Urubupunga 
SBUR => Uberaba Юбераба
SBVG => Varginha 
SBVH => Vilhena 
SBVT => Vitoria Витория
SCAC => Ancud Анкуд
SCAN => Los Andes 
SCAP => Alto Palena Альто-Палена
SCAR => Arica Арика
SCAS => Puerto Aisen Пуэрто-Айсен
SCAT => Copiapo Копьяпо
SCBA => Balmaceda Балмаседа
SCBE => Tocopilla Токопийа
SCCC => Chile Chico Чиле-Чико
SCCF => Calama Калама
SCCH => Chillan Чиллан
SCCI => Punta Arenas Пунта Аренас
SCCY => Coyhaique Койайке
SCDA => Iquique Икуике
SCEL => Santiago Сантьяго
SCES => El Salvador Сальвадор
SCFA => Antofagasta Антофагаста
SCFI => Frutillar Фрутильяр
SCFM => Porvenir Порвенир
SCFT => Futaleufu Футалеуфу
SCGE => Los Angeles Лос Анджелес
SCGZ => Puerto Williams Пуэрто-Вильямс
SCHR => Cochrane Кочране
SCIE => Concepcion Консепсьон
SCIP => Baca Grande 
SCIP => Isla de Pascua, Easter Island 
SCIP => Puerto La Victoria 
SCIP => Puka Puka Is/Attol 
SCIP => Brooks Lodge 
SCIP => Rairua 
SCIP => Rowan Bay 
SCJO => Osorno Осорно
SCLL => Vallenar Вайенар
SCNT => Puerto Natales Пуэрто Наталес
SCOV => Ovalle Овайе
SCPC => Pucon Пукон
SCPV => Puerto Varas Пуэрто Варас
SCQB => Coquimbo Кокимбо
SCRA => Chanaral Чаньяраль
SCRD => Valparaiso Вальпараисо
SCSB => Cerro Sombrero Сьерро-Сомбреро
SCSE => La Serena Ла Серена
SCSF => San Felipe Сан-Фелипе
SCST => Castro Кастро
SCTC => Temuco Темуко
SCTE => Puerto Montt Пуэрто Монт
SCTI => Santiago Сантьяго
SCTL => Talca Талька
SCTN => Chaiten Чайтен
SCTO => Victoria Лимбе
SCTT => Taltal Талтал
SCVL => Valdivia Вальдивия
SCVM => Vina del Mar Винья-дель-Мар
SDAM => Campinas Кампинас
SDCO => Sorocaba Сорокаба
SDJL => Jales 
SDOU => Ourinhos 
SDRS => Resende 
SDUB => Ubatuba Убатуба
SDVG => Votuporanga 
SEAM => Ambato Амбато
SECO => Coca Кока
SECU => Cuenca Куенка
SEGS => Galapagos Is 
SEGY => Guayaquil Гуайяквил
SEJI => Jipijapa Хипихапа
SEMA => Macara 
SEMC => Macas Макас
SEMH => Machala Мачала
SEMT => Manta 
SENL => Lago Agrio Лаго-Агрио
SEPT => Putumayo Путумайо
SEPV => Portoviejo Портовьехо
SEQU => Quito Куито
SESA => Salinas 
SESC => Sucua Сукуа
SESM => Pastaza Пастаца
SEST => Puerto Baquerizo Moreno, San Cristуbal Island, Galбpagos Islands 
SESV => Bahia De Caraquez 
SETH => Taisha Таиша
SETI => Tiputini Типутини
SETM => Catamayo, Loja 
SETN => Esmeraldas 
SETR => Tarapoa Тарапоа
SETU => Tulcan 
SFAL => Port Stanley 
SGAS => Asuncion Асунсьон
SGEN => Encarnacion Инкарнасьон
SGES => Ciudad Del Este Кудад-дель-Эсте
SGFI => Filadelfia Филадельфия
SGME => Mariscal Estigarribia Марискал-Эстигар
SGPI => Pilar Пилар
SGPJ => Pedro Juan Caballero Педро-Хуан-Кабальеро
SIGF => Berkeley 
SIMK => Franca Франка
SIPK => Selma 
SIZX => Juara Жуара
SKAC => Araracuara Араракуара
SKAD => Acandi Аканди
SKAM => Amalfi Амалфи
SKAN => Andes Андес
SKAP => Apiay Апиай
SKAR => Armenia Армения
SKAS => Puerto Asis Пуэрто-Асис
SKBC => El Banco Эль-Банко
SKBG => Bucaramanga 
SKBO => Bentota River 
SKBO => Bogota Богота
SKBO => Qeqertaq 
SKBQ => Barranquilla Барранкуилла
SKBS => Bahia Solano Бахья-Солано
SKBU => Buenaventura Буэнавентура
SKCA => Capurgana Капургана
SKCC => Cucuta 
SKCD => Condoto Кондото
SKCG => Cartagena Картегена
SKCG => Alameda 
SKCI => Carimagua Каримагуа
SKCL => Cali Кали
SKCM => Cimitarra Кимитарра
SKCN => Cravo Norte Краво-Норте
SKCO => Tumaco Тумако
SKCP => Bahia Cupica Бахья-Купика
SKCR => Caruru Каруру
SKCU => Caucasia Каукасиа
SKCV => Covenas Ковенас
SKCZ => Corozal Корозал
SKEB => El Bagre 
SKEJ => Barrancabermeja Барранкабермежа
SKFL => Florencia Флоренсиа
SKGA => Las Gaviotas Лас-Гавиотас
SKGB => Fortuna Ledge 
SKGI => Girardot 
SKGO => Cartago Картаго
SKGP => Guapi Гуапи
SKGY => Guamal Гуамал
SKGZ => Villagarzon Виллагарсон
SKHA => Chaparral Чапаррал
SKHC => Hato Corozal Хато-Коросал
SKIB => Ibague Ибаги
SKIG => Chigorodo Чигородо
SKIO => Mompos 
SKIP => Ipiales Ипиалес
SKLC => Apartado Апартадо
SKLG => Puerto Leguizamo 
SKLM => Maicao Маикао
SKLP => La Pedrera Ла-Педрера
SKLT => Leticia 
SKMD => Medellнn 
SKMF => Miraflores Мирафлорес
SKMG => Magangue 
SKML => Monte Libano Монте-Либано
SKMR => Monteria Монтериа
SKMU => Mitu Миту
SKMZ => Manizales Манисалес
SKMZ => Hatton 
SKNC => Necocli Некокли
SKNQ => Nuqui Нуки
SKNV => Neiva Нейва
SKOC => Ocana Окана
SKOE => Orocue Ороке
SKOT => Otu Оту
SKPC => Puerto Carreno Пуэрто-Каррено
SKPD => Puerto Inirida Пуэрто-Инирида
SKPE => Pereira 
SKPI => Pitalito Питалито
SKPL => Plato Плато
SKPN => Nare Наре
SKPP => Popayan Попайан
SKPQ => Palanquero Паланкеро
SKPR => Puerto Berrio Пуэрто-Беррио
SKPS => Pasto Пасто
SKPV => Providencia Провиденсиа
SKPZ => Paz De Ariporo 
SKQU => Mariquita Марикита
SKRG => Medellin Меделлин
SKRH => Riohacha Риохача
SKSA => Saravena Саравена
SKSJ => San Jose Del Gua 
SKSM => Santa Marta Санта Марта
SKSO => Sogamoso Согамосо
SKSP => San Andres Island Остров Сан Андрес
SKSR => San Marcos Сан-Маркос
SKSV => San Vicente 
SKTA => Tauramena Таурамена
SKTB => Tibu Тибу
SKTD => Trinidad Тринидад
SKTL => Tolu Толу
SKTM => Tame Таме
SKTQ => Tres Esquinas Трес-Эскинас
SKTU => Turbo Турбо
SKUC => Arauca Араука
SKUI => Quibdo Кибдо
SKUL => Tulua Тулуа
SKUR => Urrao Уррао
SKVL => Puerto Boyaca Пуэрто-Бояка
SKVP => Valledupar Валледупар
SKVV => Villavicencio 
SKYA => Yaguara Ягуара
SKYP => El Yopal Эль-Йопал
SLAP => Apolo Аполо
SLAS => Ascension Аскеншн
SLBJ => Bermejo Бермехо
SLBU => Baures 
SLCA => Camiri Камири
SLCB => Cochabamba Качабамба
SLCO => Cobija Кобиха
SLCO => Klag Bay 
SLCO => Parks 
SLCP => Concepcion Консепсьон
SLET => Santa Cruz Санта-Круз-Айленд
SLGY => Guayaramerin Гуаярамерин
SLHJ => Huacaraje 
SLJE => San Jose Сан-Хосе
SLJO => San Joaquin Сан-Хоакин
SLJV => San Javier Сан-Хавьер
SLLP => La Paz Ла Пас
SLMG => Magdalena Магдалена
SLOR => Oruro Оруро
SLPO => Potosi Потоси
SLPR => Puerto Rico Пуэрто Рико
SLPS => Puerto Suarez 
SLRA => San Ramon Сан-Рамон
SLRB => Robore Роборе
SLRI => Riberalta Риберальта
SLRQ => Rurrenabaque Рурренабак
SLRY => Reyes Рейес
SLSA => Santa Ana Санта-Ана
SLSB => San Borja Сан-Борха
SLSI => San Ignacio De Velasco 
SLSM => San Ignacio De M 
SLSR => Santa Rosa Санта-Роса
SLSU => Sucre Сукре
SLTJ => Tarija 
SLTR => Trinidad Тринидад
SLVG => Vallegrande 
SLVM => Villamontes 
SLVR => Santa Cruz Санта-Круз-Айленд
SLYA => Yacuiba Якуйба
SMBN => Albina Альбина
SMCO => Totness Тотнесс
SMDA => Drietabbetje Дриетаббетье
SMJP => Paramaribo 
SMNI => Nieuw Nickerie 
SMNI => Niblack 
SMPA => Paloemeu Паломеу
SMST => Stoelmans Eiland 
SMWA => Wageningen Вагенинген
SMZO => Paramaribo 
SNAI => Alto Parnaiba 
SNAL => Arapiraca 
SNAP => Newport Beach Ньюпорт Бич
SNAR => Almenara 
SNBC => Barra Do Corda 
SNBF => Senhor Do Bonfim 
SNBG => Buochs Буокс
SNBL => Belmonte Бельмонте
SNBR => Barreiras 
SNBS => Balsas 
SNBU => Brumado 
SNBX => Barra 
SNCP => Carutapera 
SNDC => Redencao Реденкао
SNDN => Leopoldina 
SNDV => Divinopolis 
SNED => Canavieiras 
SNFM => Fasa 
SNFM => Stow 
SNFX => Sao Felix Do Xingu 
SNGD => Guadalupe Гуадалупе
SNGI => Guanambi 
SNGM => Guimaraes Гимараес
SNHA => Itabuna 
SNIC => Irece 
SNIO => Chomley 
SNIU => Ipiau 
SNJB => Jacobina 
SNJK => Jequie 
SNJN => Januaria 
SNKE => Santana Do Araguaia 
SNLO => Sao Lourenco Сан-Лоуренсу
SNMA => Monte Alegre 
SNMU => Mucuri 
SNMX => Sao Mateus 
SNMZ => Porto de Moz 
SNNU => Nanuque 
SNOS => Passos Пассос
SNOX => Oriximina 
SNPC => Picos 
SNPX => Pirapora 
SNQG => Floriano 
SNRD => Prado Прадо
SNRU => Caruaru 
SNSW => Soure 
SNTI => Obidos Обидос
SNTO => Teofilo Otoni 
SNVB => Valenca 
SNVS => Breves 
SNWC => Camocim 
SNXO => Patos De Minas 
SNXO => Polk Inlet 
SNXQ => Tasiuasaq 
SNXQ => Paris Париж
SNXQ => Adelaide Аделаида
SNXQ => Ahmed Al Jaber 
SNXQ => Milan Милан
SNXQ => Ilimanaq 
SNXQ => Verona Верона
SNXQ => Vojens 
SNXQ => Ronneby Роннеби
SNXQ => Alvesta 
SNXQ => Katrineholm 
SNXQ => Hedemora 
SNXQ => Sala 
SNYE => Pinheiro 
SNYH => Itambacuri 
SNZA => Pouso Alegre 
SNZW => Itubera 
SOCA => Cayenne 
SOOA => Maripasoula Марипасула
SOOG => St Georges de lOyapock 
SOOM => St Laurent du Maroni 
SOOR => Regina Регина
SOOS => Saul Саул
SPAO => San Juan Aposento Сан-Хуан-Апосенто
SPAR => Alerta Алерта
SPAY => Attock 
SPBB => Moyobamba Мойобамба
SPBL => Bellavista Беллависта
SPBR => Iberia Иберия
SPCL => Pucallpa Пукальпа
SPEO => Chimbote Чимботе
SPGM => Tingo Maria Тинго-Мария
SPHI => Chiclayo Чиклайо
SPHO => Ayacucho Аякучо
SPHY => Andahuaylas Андауайлас
SPHZ => Anta Анта
SPIL => Quincemil 
SPIM => Cabin Creek 
SPIM => Cacador 
SPIM => Lima Лима
SPJA => Rioja Риоха
SPJI => Juanjui Хуанхуй
SPJJ => Jauja Хауха
SPJL => Juliaca Хулиака
SPJN => San Juan Сан Хуан
SPJR => Cajamarca Кахамарка
SPLN => Rodriguez De Mendoza 
SPME => Tumbes Тумбес
SPMR => Santa Maria Санта-Мария
SPMS => Yurimaguas Юримагуас
SPNC => Huanuco Уануко
SPOV => Hidden Falls 
SPOV => Shiringayoc 
SPPY => Chachapoyas Чачапояс
SPQT => Iquitos Икуитос
SPQU => Arequipa Арекуипа
SPRU => Trujillo Трухилло
SPSO => Pisco Писко
SPST => Tarapoto Тарапото
SPSU => Sinop Синоп
SPTN => Tacna 
SPTU => Puerto Maldonado Пуэрто Мальдонадо
SPUR => Piura Пиуро
SPYL => Talara 
SPZO => Cuzco Куско
SPZO => Komaio 
SPZO => Kitzingen 
SSAL => Alegrete 
SSAP => Apucarana 
SSBL => Blumenau Блюменау
SSCK => Concordia 
SSCL => Cassilandia 
SSCP => Cornelio Procopio 
SSDO => Dourados 
SSER => Erechim 
SSFB => Francisco Beltrao 
SSIJ => Ijui 
SSIQ => Itaqui 
SSJA => Joacaba 
SSLI => Livramento 
SSNJ => Ceuta Сеута
SSOG => Arapongas 
SSPB => Pato Branco 
SSPG => Paranagua 
SSPI => Paranavai 
SSPN => Paranaiba 
SSUM => Umuarama 
SSVP => Santa Vitoria 
SSWD => Decatur Island 
SSZR => Santa Rosa Санта-Роса
SUAG => Artigas Артигас
SUBU => Bella Union Белла-Юнион
SUCA => Colonia Колония
SUDU => Durazno 
SULS => Maldonado 
SUMO => Melo Мело
SUMU => Montevideo Монтевидео
SUPU => Paysandu Пайсанду
SURV => Rivera Ривера
SUSO => Salto 
SUTB => Tacuarembo Такуарембо
SUTR => Treinta-y-Tres 
SUVO => Vichadero Вичадеро
SVAC => Acarigua Акарикуа
SVAN => Anaco Анако
SVAS => Pijiguaos Пихигуаос
SVBC => Barcelona Барселона
SVBI => Barinas Баринас
SVBL => Maracay Маракай
SVBM => Barquisimeto Баркисимето
SVCB => Ciudad Bolivar Сьюдад-Боливар
SVCD => Caicara Del Orinoco 
SVCG => Casigua 
SVCL => Calabozo Калабосо
SVCN => Canaima Канайма
SVCO => Carora Карора
SVCP => Carupano Карупано
SVCR => Coro Коро
SVCU => Cumana Кумана
SVED => El Dorado Эль-Дорадо
SVEZ => Elorza Элорса
SVGD => Guasdualito 
SVGI => Guiria Гуйриа
SVGU => Guanare Гуанаре
SVIC => Icabaru Икабару
SVJC => Las Piedras Лас-Пьедрас
SVKA => Kavanayen Каванаен
SVKM => Kamarata 
SVLF => La Fria Ла-Фриа
SVMC => Maracaibo Маракайбо
SVMD => Merida Мериба
SVMG => Porlamar 
SVMI => Caracas Каракас
SVMI => Margaret River Маргарет Ривер
SVMT => Maturin Матурин
SVON => Cabimas Кабимас
SVPA => Puerto Ayacucho Пуэрто-Аякучо
SVPC => Puerto Cabello 
SVPE => Pedernales Педерналес
SVPM => San Cristobal Сан-Кристобаль
SVPR => Ciudad Guayana Сьюдад-Гуаяна
SVPT => Palmarito Палмарито
SVRS => Los Roques Лос-Рокес
SVSA => San Antonio Сен Антонио
SVSB => Santa Barbara Ba 
SVSE => Santa Elena Санта-Элена
SVSO => Santo Domingo Санто-Доминго
SVSP => San Felipe Сан-Фелипе
SVSR => San Fernando De Apure 
SVST => San Tome Сан-Томе
SVSZ => Santa Barbara Ed 
SVTC => Tucupita Тукупита
SVTM => Tumeremo Тумеремо
SVUM => Uriman Уриман
SVVA => Valencia Валенсия
SVVG => El Vigia Эль-Вигиа
SVVL => Valera Валера
SVVP => Valle De Pascua 
SWBC => Barbelos 
SWBR => Borba Борба
SWCA => Carauari 
SWCQ => Costa Marques 
SWDM => Diamantino 
SWDN => Dianopolis 
SWEC => Aragarcas 
SWEI => Eirunepe 
SWFJ => Feijo 
SWFX => Sao Felix Do Araguaia 
SWGI => Gurupi 
SWGN => Araguaina 
SWII => Ipiranga Ипиранга
SWIY => Santa Isabel do Morro 
SWJI => Ji-Parana 
SWJN => Juina 
SWJU => Juruena 
SWKC => Caceres Касерес
SWKN => Caldas Novas 
SWKO => Coari 
SWKT => Catalao 
SWLB => Labrea 
SWLC => Rio Verde Риу-Верди
SWMW => Maues 
SWNA => Aripuana 
SWNI => Ariquemes 
SWNK => Boca Do Acre 
SWNQ => Niquelandia 
SWNS => Anapolis 
SWPI => Parintins 
SWPM => Pimenta Bueno 
SWRA => Arraias 
SWRD => Rondonopolis 
SWSI => Sinop Синоп
SWSN => Sena Madureira 
SWST => Santa Terezinha Санта-Терезинья
SWUA => Sao Miguel Araguaia 
SWVC => Vila Rica Вила-Рика
SWXV => Nova Xavantina Нова-Шавантина
SYAH => Aishalton Аисхалтон
SYAN => Annai Аннаи
SYBE => Bemichi Бемичи
SYBR => Baramita Барамита
SYBT => Bartica Бартика
SYEK => Ekereku Экереку
SYGO => Ogle Огле
SYIB => Imbaimadai Имбаимадай
SYKA => Kaieteur Каетер
SYKM => Kamarang Камаранг
SYKP => Kurupung Курупунг
SYKR => Karanambo Каранамбо
SYKS => Karasabai Карасабаи
SYKT => Kato Като
SYKZ => Konawaruk Конаварук
SYLP => Lumid Pau Лумид-Пау
SYLT => Lethem Летем
SYMB => Mabaruma Мабарума
SYMD => Mahdia Мадиа
SYMM => Monkey Mountain Манки-Маунтин
SYMR => Matthews Ridge Маттьюс-Ридж
SYOR => Orinduik Ориндук
SYPL => Pipillipai Пипиллипаи
SYPM => Paramakotoi 
SYPR => Paruima Парума
SYSK => Skeldon Скелдон
TAPA => "St. John&#039;s "
TAPA => Con Dao 
TAPH => Barbuda 
TBPB => Bridgetown 
TDCF => Roseau 
TDPD => Dominica Доминика
TFFA => La Desirade Ла-Дезираде
TFFB => Basse Terre 
TFFC => St Francois 
TFFF => Fort De France 
TFFG => St Martin 
TFFG => St Martin 
TFFJ => St Barthelemy 
TFFM => Marie Galante Мари-Галанте
TFFR => Pointe-a-pitre 
TFFR => Pleasant Harbour 
TFFS => Terre-de-Haut 
TGPY => St. Georges 
TGPZ => Carriacou Is 
TIST => Charlotte Amalie, St Thomas 
TISX => St Croix Island 
TJAB => Arecibo 
TJBQ => Aguadilla 
TJCP => Culebra 
TJFA => Fajardo 
TJIG => San Juan Сан Хуан
TJMZ => Mayaguez 
TJNR => Roosevelt Roads 
TJPS => Ponce 
TJSJ => San Juan Сан Хуан
TJVQ => Vieques 
TKPK => Katugastota 
TKPK => Kwun Tong 
TKPK => Basseterre, St. Kitts Island 
TKPN => Nevis 
TLPC => Castries 
TLPL => St Lucia 
TLPL => West Kavik 
TNCA => Aruba 
TNCB => Kralendijk 
TNCC => Curacao 
TNCE => St Eustatius 
TNCM => Philipsburg, St. Maarten 
TNCS => Saba Island 
TQPF => Anguilla 
TRPG => "Gerald&#039;s Park "
TTCP => Tobago 
TTPP => Port Of Spain 
TUPA => Anegada Анегада
TUPJ => Beef Island 
TUPJ => Peenemuende 
TUPW => Spanish Town/Virgin Gorda 
TVSB => Bequia 
TVSC => Canouan Island 
TVSM => Mustique Island Мистик-Айленд
TVSU => Union Island Юнион-Айленд
TVSV => Ad-Dabbah 
TVSV => Wildman Lake 
TVSV => St Vincent 
TXKF => Bermuda 
UAAA => Almaty Алматы
UAAA => St Anton 
UAAH => Balhash Балхаш
UAAT => Taldy-Kurgan Талды-Курган
UACC => Astana Астана
UACK => Kokshetau Кокшетау
UACP => Petropavlovsk Петропавловск
UADD => Zhambyl Жамбыл
UAFM => Bishkek Бишкек
UAFO => Osh Ош
UAII => Shimkent Шимкент
UAKD => Zhezkazgan Жезказган
UAKK => Karaganda Караганда
UAOO => Kzyl-Orda Кзыл-Орда
UARR => Uralsk Уральск
UASB => Ekibastuz Экибастуз
UASE => Zaisan Зайсан
UASK => Ust-kamenogorsk Усть-Каменогорск
UASP => Pavlodar Павлодар
UASS => Semipalatinsk Семипалатинск
UATE => Aktau Актау
UATG => Atyrau Атырау
UATT => Aktyubinsk Актюбинск
UAUR => Arkalyk Аркалык
UAUU => Kostanay Костанай
UBBB => Baku Баку
UBBG => Gyandzha Гянджа
UBBN => Nakhichevan Нахичевань
UDSG => Gyoumri 
UDYZ => Yerevan Ереван
UEEA => Aldan Алдан
UEEE => Yakutsk Якутск
UELL => Chulman Чульман
UELL => Neryungri Нерюнгри
UERP => Polyarnyj Полярный
UERR => Mirnyj Мирный
UESO => Chokurdah Чокурдах
UESS => Cherskiy Черский
UEST => Tiksi Тикси
UGKO => Kutaisi Кутаиси
UGSB => Batumi Батуми
UGSS => Sukhumi Сухуми
UGTB => Luzamba 
UGTB => New York Нью-Йорк
UGTB => Glenview 
UGTB => Tbilisi Тбилиси
UHBB => Blagoveschensk Благовещенск
UHBI => Magdagachi Магдагачи
UHBW => Tynda Тында
UHHH => Khabarovsk Хабаровск
UHKK => Komsomolsk Na Amure Комсомольск на Амуре
UHMA => Anadyr Анадырь
UHMD => Provideniya Бухта Провидения
UHMD => Provideniya Бухта Провидения
UHMM => Magadan Магадан
UHMP => Pack Creek 
UHMP => Pevek Певек
UHOO => Okhotsk Охотск
UHPP => Petropavlovsk-Kamchats Петропавловск-Камчатский
UHSS => Yuzhno-Sakhalinsk Южно-Сахалинск
UHWW => Vladivostok Владивосток
UIAA => Chita Чита
UIBB => Bratsk Братск
UIBS => Ust-Ilimsk Усть-Илимск
UIII => Irkutsk Иркутск
UITT => Ust-Kut Усть-Кут
UIUU => Ulan-ude Улан-Удэ
UJAP => Ujae Island Удже-Айленд
UKBB => Borispol Борисполь
UKCC => Donetsk Донецк
UKCK => Kramatorsk Краматорск
UKCM => Mariupol Мариуполь
UKCS => Severodoneck Северодонецк
UKCW => Lugansk Луганск
UKDB => Berdyansk Бердянск
UKDD => Dnepropetrovsk Днепропетровск
UKDE => Zaporozhye Запорожье
UKDR => Krivoy Rog Кривой Рог
UKFF => Simferopol Симферополь
UKFK => Kerch Керчь
UKHH => Kharkov Харьков
UKHP => Poltava Полтава
UKHS => Sumy Сумы
UKKE => Cherkassy Черкассы
UKKG => Kirovograd Кировоград
UKKK => Kiev Киев
UKKL => Chernigov Чернигов
UKLC => Lutsk Луцк
UKLH => Khmelnitskiy Хмельницкий
UKLI => Ivano-Frankovsk Ивано-Франковск
UKLL => Lviv Львов
UKLN => Chernovtsy Черновцы
UKLR => Rovno Ровно
UKLT => Ternopol Тернополь
UKLU => Uzhgorod Ужгород
UKOH => Kherson Херсон
UKON => Nikolaev Николаев
UKOO => Odessa Одесса
UKWW => Vinnica Винница
ULAA => Arkhangelsk Архангельск
ULAM => Naryan-Mar Нарьян-Мар
ULAS => Solovetsky Соловецкий
ULBC => Cherepovets Череповец
ULDD => Amderma Амдерма
ULKK => Kotlas Котлас
ULLI => St Petersburg Санкт-Петербург
ULMK => Kirovsk Кировск
ULMM => Murmansk Мурманск
ULNN => Novgorod Новгород
ULOL => Velikiye Luki Великие Луки
ULOO => Pskov Псков
ULPB => Petrozavodsk Петрозаводск
ULSS => St Petersburg Санкт-Петербург
ULWU => Velikij Ustyug Великий Устюг
ULWW => Vologda Вологда
UMBB => Brest Брест
UMGG => Gomel Гомель
UMII => Vitebsk Витебск
UMKK => Kaliningrad Калининград
UMMG => Grodna Гродно
UMMM => Minsk Минск
UMMS => Minsk Минск
UMOO => Mogilev Могилев
UNAA => Abakan Абакан
UNBB => Barnaul Барнаул
UNEE => Kemerovo Кемерово
UNII => Eniseysk Енисейск
UNKL => Krasnojarsk Красноярск
UNKS => Achinsk Ачинск
UNKY => Kyzyl Кызыл
UNNT => Novosibirsk Новосибирск
UNOO => Omsk Омск
UNSS => Strzhewoi Стрежевой
UNTT => Tomsk Томск
UNWW => Novokuznetsk Новокузнецк
UODD => Dikson Диксон
UOHH => Hatanga Хатанга
UOII => Igarka Игарка
URKA => Anapa Анапа
URKG => Gelendzik Геленджик
URKK => Krasnodar Краснодар
URMG => Groznyj Грозный
URML => Makhachkala Махачкала
URMM => Mineralnye Vody Минеральные Воды
URMM => Vienna Вена
URMM => Ventspils Вентспилс
URMN => Nalchik Нальчик
URMO => Vladikavkaz Владикавказ
URMT => Stavropol Ставрополь
URRR => Rostov Ростов
URRY => Volgodonsk Волгодонск
URSS => Adler Адлер
URWA => Astrakhan Астрахань
URWI => Elista Элиста
URWW => Volgograd Волгоград
USCC => Chelyabinsk Челябинск
USCM => Magnitogorsk Магнитогорск
USDD => Salekhard Салехард
USHH => Khanty-mansiysk Ханты-Мансийск
USHU => Uraj Урай
USII => Izhevsk Ижевск
USKK => Kirov Киров
USMM => Nadym Надым
USMU => Novy Urengoy Новый Уренгой
USNN => Nizhnevartovsk Нижневартовск
USNR => Raduzhnyi Радужный
USPP => Perm Пермь
USRK => Kogalym Когалым
USRN => Nefteyugansk Нефтеюганск
USRO => Nojabrxsk Ноябрьск
USRR => Surgut Сургут
USSS => Ekaterinburg Екатеринбург
USTO => Tobolsk Тобольск
USTR => Tyumen Тюмень
USUU => Kurgan Курган
UTAA => Ashgabat Ашхабад
UTAK => Turkmenbashi 
UTAM => Mary 
UTAT => Dashoguz 
UTAV => Turkmenabad 
UTDD => Dushanbe 
UTDL => Khudzhand 
UTFF => Fergana Фергана
UTKA => Andizhan Андижан
UTKN => Namangan Наманган
UTNN => Nukus Нукус
UTNU => Urgench Ургенч
UTSB => Bukhara Бухара
UTSL => Karshi Карши
UTSS => Samarkand Самарканд
UTST => Termez Термез
UTTT => Tashkent Ташкент
UUBA => Kostroma Кострома
UUBB => Bussellton 
UUBB => Belburn 
UUBC => Kaluga Калуга
UUBI => Ivanovo Иваново
UUBK => Rybinsk Рыбинск
UUBN => Naples Неаполь
UUBP => Briansk Брянск
UUBS => Smolensk Смоленск
UUBT => Tula Тула
UUDD => Moscow Москва
UUDL => Yaroslavl Ярославль
UUEE => Moscow Москва
UUEM => Tver Тверь
UUOB => Belgorod Белгород
UUOK => Kursk Курск
UUOL => Lipetsk Липецк
UUOO => Voronezh Воронеж
UUOR => Orel Орел
UUOT => Tambov Тамбов
UUWR => Ryazan Рязань
UUWW => Moscow Москва
UUYH => Ukhta Ухта
UUYH => Umnugobitour 
UUYI => Inta Инта
UUYP => Pechora Печора
UUYS => Usinsk Усинск
UUYW => Vorkuta Воркута
UUYY => Syktyvkar Сыктывкар
UWGG => Nizhniy Novgorod Нижний Новгород
UWKB => Bugulma Бугульма
UWKD => Kazan Казань
UWKE => Naberevnye Chelny Набережные Челны
UWKJ => Joshkar-Ola Йошкар-Ола
UWKS => Cheboksary Чебоксары
UWLW => Ulyanovsk Ульяновск
UWOO => Orenburg Оренбург
UWOR => Orsk Орск
UWPP => Penza Пенза
UWPS => Saransk Саранск
UWSB => Balakovo Балаково
UWSS => Saratov Саратов
UWUB => Beloreck Белорецк
UWUF => Neftekamsk Нефтекамск
UWUK => Oktiabrskij Октябрьский
UWUU => Ufa Уфа
UWUU => Havana Гавана
UWWW => Samara Самара
VAAH => Ahmedabad Ахмедабад
VAAK => Akola Акола
VAAU => Aurangabad Аурангабад
VABB => Mumbai 
VABB => Paimiut 
VABI => Bilaspur Биласпур
VABJ => Bhuj Бхудж
VABM => Belgaum Белгаум
VABO => Vadodara 
VABP => Bhopal Бхопал
VABV => Bhavnagar Бхавнагар
VADN => Daman Даман
VAGN => Guna Гуна
VAGO => Goa Гоа
VAHB => Hubli Хубли
VAID => Dezful 
VAID => Indore Индор
VAJB => Jabalpur Джабалпур
VAJM => Jamnagar Джамнагар
VAKE => Kandla Кандия
VAKJ => Khajuraho Кхаджурахо
VAKP => Kolhapur Колхапур
VAKS => Keshod Кешод
VAND => Nanded Нандед
VANP => Nagpur Нагпур
VANR => Nasik Насик
VAPO => Pinotepa Nacional 
VAPO => Pune Пуне
VAPR => Porbandar Порбандар
VARG => Ratnagiri Ратнагири
VARK => Rajkot Раджкот
VARP => Raipur Райпур
VASL => Sholapur Шолапур
VASU => Surat Сурат
VAUD => Udaipur Удайпур
VBHD => Henzada Хензада
VBPP => Papun Папун
VCBI => Colombo Коломбо
VCCA => Ampara 
VCCB => Batticaloa 
VCCG => Gal Oya Гал-Ойя
VCCJ => Jaffna Джафна
VCCK => Koggala Коггала
VCCT => Trincomalee Тринкомали
VCCW => Wirawila 
VDBG => Battambang Баттамбанг
VDKH => Kompong-Chhna 
VDKK => Koh Kong 
VDKT => Kratie Кратье
VDPP => Hartford Хартфорд
VDPP => Phnom Penh Пном Пен
VDSR => Siem Reap Сием Рип
VDST => Stung Treng 
VDSV => Sihanoukville 
VEAN => Along Алонг
VEAT => Agartala Агартала
VEAZ => Aizawl Айзаул
VEBD => Bagdogra Багдогра
VEBG => Balurghat Балургат
VEBI => Shillong Шиллонг
VEBS => Bhubaneswar Бхубанесвар
VECC => Kolkata 
VECO => Cooch Behar Куч-Бехар
VEDB => Dhanbad Дханбад
VEDZ => Daparizo Дапаризо
VEGK => Gorakhpur Горахпур
VEGT => Gawahati 
VEGY => Gaya Гайя
VEIM => Imphal Имфал
VEJP => Jeypore Джейпор
VEJS => Jamshedpur Джамшедпур
VEJT => Jorhat Йорхат
VEKM => Kamalpur Камалпур
VEKR => Kailashahar Кайлашахар
VEKU => Silchar Силчар
VEKW => Khowai Ховаи
VELR => Lilabari Лилабари
VEMH => Malda Малда
VEMN => Dibrugarh Дибругарх
VEMN => Mohanbari Моханбари
VEMR => Dimapur Димапур
VEMZ => Muzaffarpur Музаффарпур
VEPG => Pasighat Пасигхат
VEPT => Patna Патна
VERC => Ranchi Ранчи
VERK => Rourkela Руркела
VERU => Rupsi Рупси
VETJ => Tezu Тезу
VETZ => Tezpur Тезпур
VEVZ => Vishakhapatnam Вишакхапатнам
VEZO => Zero Зеро
VGBR => Barisal Барисал
VGCM => Comilla Комилла
VGEG => Chittagong 
VGIS => Ishurdi 
VGJR => Jessore Джессор
VGKN => Khulna Кхулна
VGRG => Rangpur Рангпур
VGRJ => Rajshahi 
VGSD => Saidpur 
VGSG => Thakurgaon Такургаон
VGSH => Shamshernagar Шамшернагар
VGSY => Sylhet 
VGZR => Dhaka 
VGZR => Vulcano 
VGZR => Lianhuashan 
VGZR => Utica 
VGZR => Hampton 
VGZR => The Hague Гаага
VHHH => Ciudad Real Сиудад Реаль
VHHH => Cherokee Чероки
VHHH => Callaway Gardens 
VHHH => Hong Kong Гонконг
VHHH => Hanna 
VHHH => Koethen 
VHHH => Katiu 
VHHH => Long Banga 
VHHH => Lost Harbor 
VHHH => Little Port Walter 
VIAG => Agra Агра
VIAL => Allahabad Аллахабад
VIAR => Amritsar Амритсар
VIBK => Bikaner Биканер
VIBN => Varanasi Варанаси
VIBR => Bhuntar Kullu. 
VIBT => Bhatinda Бхатинда
VICG => Chandigarh Чандигарх
VICX => Nha Trang Нха Транг
VIDN => Dehra Dun Дера Дун
VIDP => New Delhi Нью Дели
VIGG => Dharamsala Дхарамсала
VIGR => Gwalior Гвалиор
VIHR => Hissar Хиссар
VIJO => Jodhpur Джодхпур
VIJP => Jaipur Джайпур
VIJR => Jaisalmer Джайсалмер
VIJU => Jammu Джамму
VIKA => Kanpur Канпур
VIKO => Kota Мота
VILD => Ludhiana Лудхиана
VILH => Leh Лех
VILK => Lucknow Лакнау
VIPK => Pathankot Патханкот
VIPT => Pantnagar Пантнагар
VIRB => Bareli 
VISM => Simla Симла
VISR => Srinagar Сринагар
VIST => Satna Сатна
VLAP => Attopeu Аттопью
VLHS => Houeisay Хоуисей
VLHS => Ban Houei 
VLKG => Khong Кхонг
VLLB => Luang Prabang Луанг Прабанг
VLLN => Luang Namtha Луанг-Намтха
VLOS => Oudomxay Удомхей
VLPS => Paksane Паксан
VLPS => Pakse Паксе
VLSB => Xayabury Ксейабери
VLSB => Sayaboury Сайабори
VLSK => Savannakhet Сваннакхэт
VLSN => Sam Neua 
VLSV => Saravane Сараване
VLTK => Thakhek Тхакхек
VLVT => Vientiane Виентиане
VLVV => Viengxay 
VLXK => Xieng Khouang Ксьенг-Кхуанг
VLXL => Xienglom Ксьенглом
VMMC => Macau Макао
VNBG => Bajhang Баджханг
VNBJ => Bhojpur Бхойпур
VNBL => Baglung Баглунг
VNBP => Bharatpur Бхаратпур
VNBR => Bajura Баджура
VNBT => Baitadi Байтади
VNBW => Bhairawa Бхайрава
VNBW => Ponta de Ouro 
VNCG => Bhadrapur Бхадрапур
VNCJ => Chaurjhari Чаурджхари
VNDG => Dang Данг
VNDH => Dhangarhi Дхангархи
VNDL => Darchula Дарчула
VNDP => Dolpa Дольпа
VNDT => Silgadi Doti Силгади-Доти
VNGK => Gorkha Горкха
VNJI => Jiri Джири
VNJL => Jumla Джумла
VNJP => Janakpur Джанакпур
VNJS => Jomsom Джомсом
VNKT => Kathmandu Катманду
VNLD => Lamidanda Ламиданда
VNLK => Lukla Лукла
VNLT => Langtang Лангтанг
VNMA => Manang Мананг
VNMG => Meghauli Мегхаули
VNMN => Mahendranagar Махендранагар
VNNG => Nepalganj Непалгандж
VNPK => Pokhara Покхара
VNPL => Phaplu Пхалпу
VNRB => Rajbiraj Раджбирадж
VNRC => Ramechhap Рамечхап
VNRK => Rukumkot Рукумкот
VNRP => Rolpa Ролпа
VNRT => Rumjatar 
VNSB => Syangboche 
VNSI => Simara Симара
VNSK => Surkhet 
VNSR => Sanfebagar Санфебагар
VNST => Simikot Симикот
VNTJ => Taplejung Тапледжунг
VNTP => Tikapur Тикапур
VNTR => Tumling Tar 
VNVT => Biratnagar Биратнагар
VOAT => Agatti Island Агатти-Айленд
VOBI => Bellary Беллари
VOBL => Bangalore Бангалор
VOBZ => Vijayawada Виджаявада
VOCB => Coimbatore Коимбаторе
VOCI => Kochi Кочи
VOCI => Kahramanmaras 
VOCL => Kozhikode 
VOCP => Cuddapah Куддапах
VOCX => Car Nicobar Кар-Никобар
VOHS => Hyderabad Хидерабад
VOMD => Madurai Мадурай
VOML => Mangalore Мангалор
VOMM => Chennai/Madras 
VOMY => Mysore Майсор
VONV => Neyveli Нейвели
VOPB => Port Blair Порт-Блер
VOPC => Pondicherry Пондичерри
VORG => Ramagundam Рамагундам
VORY => Rajahmundry Раджахмандри
VOSM => Salem 
VOTJ => Thanjavur Тханджавур
VOTP => Tirupati Тирупати
VOTR => Tiruchirapally Тиручирапалли
VOTV => Trivandrum Тривандрум
VOWA => Warangal 
VQPR => Paro Паро
VRMG => Gan Island Ген-Айленд
VRMH => Hanimaadhoo 
VRMK => Kadhdhoo 
VRMM => Male Мале
VRMT => Kaadedhdhoo 
VTBF => Pattaya Паттайя
VTBH => Lop Buri Лоп Бури
VTBK => Kamphangsaen 
VTBO => Khoy 
VTBO => Trat Трат
VTBS => Bangkok Бангкок
VTBU => Utapao 
VTCC => Chiang Mai Чанг-Май
VTCH => Mae Hong Son Мей-Хонг-Сон
VTCL => Lampang Лампанг
VTCN => Nan Нан
VTCP => Phrae Пхраэ
VTCT => Chiang Rai Чанг-Рай
VTED => Ban Mak Khaen 
VTPB => Phetchabun Пхетчабун
VTPH => Hua Hin Хуа-Хин
VTPH => Hingurakgoda 
VTPI => Takhli Такхли
VTPM => Mae Sot Мае Сот
VTPO => Sukhothai (sawankolok) 
VTPP => Phitsanulok Пхитсанусок
VTPT => Tak Так
VTPU => Uttaradit Уттарадит
VTSB => Surat Thani Сурат-Тхани
VTSC => Narathiwat Наративат
VTSE => Chumphon Чампхон
VTSF => Nakhon Si Thammarat Након-Си-Таммарат
VTSG => Krabi Краби
VTSH => Songkhla Сонгкхла
VTSK => Pattani Паттани
VTSM => Koh Samui Кох-Самуи
VTSP => Phuket Пхукет
VTSR => Ranong Ранонг
VTSS => Hat Yai Хат Яй
VTST => Trang Транг
VTUD => Udon Thani Удон Тхани
VTUI => Sakon Nakhon Сакан Накхон
VTUJ => Surin Сурин
VTUK => Khon Kaen Кхон Каен
VTUL => Loei Лоэй
VTUO => Buri Ram 
VTUQ => Nakhon Ratchasima Натхон Ратчасима
VTUU => Ubon Ratchathni Убон-Ратчатхани
VTUV => Roi Et Рой Ет
VTUW => Nakhon Phanom Накхон Патхом
VVBM => Banmethuot 
VVCI => Haiphong Хейфонг
VVCI => Kouba 
VVCM => Ca Mau Ка-Мау
VVCT => Can Tho Кан-Тхо
VVDB => Dien Bien Phu 
VVDB => Sigiriya Сигирия
VVDL => Dalat Далат
VVDN => Da Nang Да-Нанг
VVNB => Hanoi Ханой
VVNB => Chicago Чикаго
VVNS => Son-La 
VVPB => Hue Гуе
VVPC => Anniston 
VVPC => Qui Nhon 
VVPK => Pleiku Плейку
VVPQ => Copper Mountain 
VVPR => Phan Rang Пхань-Ранг
VVPT => Phan Thiet Пхань-Тхиет
VVRG => Rach Gia Рач-Дже
VVTH => Doongan 
VVTH => Tuy Hoa Туй-Хоа
VVTS => Ho Chi Minh City Хо Чи Мин Сити
VVVH => Phu Vinh Пху-Винх
VVVH => Vinh City 
VVVT => Vung Tau 
VYBG => Bagan Баган
VYBG => Nyaung-u 
VYBM => Bhamo Бамо
VYDW => Dawe 
VYGG => Gangaw Ганго
VYGW => Gwa 
VYHH => Heho Хехо
VYHL => Homalin Хомалин
VYHN => Tilin Тилин
VYKG => Keng Tung 
VYKI => Khamti Хамти
VYKL => Kalemyo Калемьо
VYKP => Kyaukpyu Кьяукпью
VYKT => Kawthaung Котонг
VYKU => Sarakhs 
VYKU => Kyauktaw Кьяуктау
VYLK => Loikaw Лойкау
VYLS => Lashio Лашио
VYMD => Mandalay Мандалай
VYME => Myeik 
VYMK => Myitkyina Мьиткьина
VYMM => Maulmyine 
VYMN => Manaung Манаунг
VYMO => Momeik Момейк
VYMS => Mong Hsat 
VYMT => Mong Ton 
VYMW => Magwe Магуэ
VYNS => Namsang Намсанг
VYNT => Namtu Намту
VYPA => Poipet 
VYPA => Pa-an 
VYPK => Pauk Паук
VYPN => Bassein Бассейн
VYPT => Putao Путао
VYPU => Pakokku Пакокку
VYPY => Prome Проме
VYSW => Sittwe 
VYTD => Thandwe 
VYTL => Tachilek Тачилек
VYYE => Ye Йе
VYYE => Assaluyeh 
VYYY => Yangon Яньгунь
WAAA => Ujung Pandang 
WAAJ => Mamuju Мамую
WAAP => Pomala 
WABB => Biak 
WABB => Kadanwari 
WABB => Zachar Bay 
WABD => Moanamani Моанамани
WABF => Numfoor Нумфоор
WABG => Wagethe Вагете
WABI => Nabire Набире
WABL => Illaga Иллага
WABN => Kokonao Коконао
WABO => Serui Серуи
WABP => Tembagapura 
WABT => Enarotali Энаротали
WADA => Mataram 
WADB => Bima Бима
WADD => Denpasar, Bali 
WADS => Sumbawa 
WADT => Tambolaka Тамболака
WADW => Waingapu Ваингапу
WAJA => Arso Арсо
WAJB => Bokondini Бокондини
WAJI => Sarmi 
WAJJ => Jayapura 
WAJL => Lereh Лерех
WAJM => Mulia Мулиа
WAJO => Oksibil Оксибил
WAJR => Waris Варис
WAJS => Senggeh Сенггех
WAJU => Ubrub 
WAJW => Wamena Вамена
WAKD => Mindiptana Миндиптана
WAKE => Bade Баде
WAKK => Merauke 
WAKK => Mundulkiri 
WAKO => Ongava Game Reserve 
WAKO => Okaba Окаба
WAKP => Kepi Кепи
WAKT => Tanahmerah Танахмерах
WALG => Tanjung Selor 
WALK => Tanjung Redep 
WALL => Balikpapan Баликпапан
WALR => Tarakan 
WALS => Samarinda Самаринда
WALT => Tanjung Santan 
WALV => Bunyu Бунью
WAMA => Galela Галела
WAMG => Gorontalo Горонтало
WAMH => Naha 
WAMI => Tolitoli Толитоли
WAMJ => Gebe Гебе
WAMK => Kau Кау
WAML => Palu 
WAMM => Manado Манадо
WAMN => Melangguane Меланггуане
WAMP => Poso Посо
WAMR => Pitu, Morotai Island 
WAMT => Ternate Тернате
WAMW => Luwuk Лувук
WAOC => Batu Licin Бату-Личин
WAOI => Pangkalanbuun Пангкаланбуун
WAON => Tanjung Warukin 
WAOO => Banjarmasin Банджармасин
WAOP => Palangkaraya 
WAOS => Sampit 
WAPA => Amahai Амахаи
WAPC => Bandanaira Банданаира
WAPD => Dobo 
WAPE => Mangole Манголе
WAPH => Labuha Лабуха
WAPI => Saumlaki Саумлаки
WAPK => Benjina Бенджина
WAPL => Langgur 
WAPN => Sanana Санана
WAPP => Ambon Амбон
WAPR => Namlea Намлеа
WAPR => Ngala 
WAPT => Taliabu Талиабу
WARA => Malang Маланг
WARJ => Yogyakarta Джогиякарта
WARQ => Solo City Соло Сити
WARR => Punta Renes Пунта Ренес
WARR => Surabaya Сурабайя
WARS => Semarang Семаранг
WASB => Bintuni Бинтуни
WASC => Ransiki Рансики
WASE => Kebar Кебар
WASF => Fak Fak 
WASG => Anggi Ангги
WASI => Inanwatan Инанватан
WASK => Kaimana Каймана
WASM => Merdey Мердей
WASO => Babo Бабо
WASO => Barrow 
WASR => Manokwari Маноквари
WASS => Sorong 
WAST => Teminabuan Теминабуан
WASW => Wasior Васиор
WATA => Atambua 
WATC => Maumere Маумере
WATE => Ende Энде
WATG => Ruteng Рутенг
WATM => Alor Island Алор-Айленд
WATO => Labuan Bajo Лабуан-Баджо
WATT => Kupang 
WATW => Lewoleba Леволеба
WAWB => Baubau 
WAWM => Emeryville 
WAWM => Masamba Масамба
WAWR => Raha Раха
WAWS => Soroako Сороако
WAWT => Tana Toraja Тана Торайа
WAWW => Kendari 
WBGB => Bintulu Бинтулу
WBGC => Belaga 
WBGD => Long Semado 
WBGF => Long Lellang Лонг-Лелланг
WBGG => Kuching Кучинг
WBGI => Long Seridan 
WBGJ => Limbang 
WBGK => Mukah 
WBGM => Marudi 
WBGN => Sematan Семантан
WBGP => Kapit 
WBGQ => Bakalalan 
WBGR => Miri Мири
WBGS => Sibu 
WBGU => Long Sukang Лонг-Суканг
WBGW => Lawas 
WBGY => Simanggang Симанганг
WBGZ => Bario 
WBKA => Semporna 
WBKD => Lahad Datu 
WBKE => Telupid Телупид
WBKG => Keningau Кенингау
WBKH => Sahabat 16 Сахабат-16
WBKK => Kota-Kinabalu 
WBKL => Labuan 
WBKL => Lamerd 
WBKL => Leron Plains 
WBKM => Tomanggong Томангонг
WBKN => Blairsville 
WBKN => Long Pasia 
WBKO => Sepulot Сепулот
WBKP => Pamol 
WBKR => Ranau Ранау
WBKS => Sandakan Сандакан
WBKT => Kudat 
WBKW => Tawau 
WBMU => Mulu, Sarawak 
WBSB => Bandar Seri Begawan Бандар Сери Бегаван
WIAG => Astraksetra Астраксетра
WIBB => Pekanbaru Пеканбару
WIBD => Dumai Думаи
WIBR => Rokot Рокот
WIBR => Sipora Сипора
WIBS => Sungai Pakning 
WIBT => Tanjung Balai 
WICC => Bandung Бандунг
WICD => Cirebon Чиребон
WICM => Torembi 
WICM => Tasikmalaya Тасикмалая
WICT => Bandar Lampung Бандар-Лампунг
WIDD => Batam 
WIDE => Pasir Pangarayan Пасир-Пангараян
WIDN => Tanjung Pinang 
WIDS => Singkep 
WIHH => Jakarta Джакарта
WIHL => Cilacap 
WIHP => Jakarta Джакарта
WIIG => Pulau Panjang 
WIMB => Gunungsitoli Гунунгситоли
WIME => Aek Godang Эк-Годан
WIMG => Padang Паданг
WIMM => Medan Медан
WIMP => Sibisa Сибиса
WIOD => Tanjung Pandan 
WIOG => Nangapinoh Нангапинох
WIOK => Ketapang 
WIOM => Matak Матак
WION => Natuna Ranai Натуна-Ранай
WIOO => Pontianak Понтианак
WIOP => Putussibau 
WIOS => Sintang 
WIPA => Jambi Джамби
WIPH => Kerinci 
WIPK => Pangkalpinang Пангкалпинанг
WIPL => Bengkulu Бенгкулу
WIPP => Palembang Палембанг
WIPQ => Pendopo Пендопо
WIPR => Rengat Ренгат
WIPU => Muko-Muko 
WIPV => Keluang Келуанг
WITA => Tapaktuan Тапактуан
WITB => Sabang 
WITC => Meulaboh Меулабох
WITL => Lhok Sukon Лхок-Сукон
WITM => Lhoksumawe 
WITT => Banda Aceh Банда Асе
WMAN => Taman Negara Таман Негара
WMAU => Mersing Мерсинг
WMBA => Sitiawan Ситиаван
WMBI => Taiping Тайпинг
WMBT => Tioman Тиоман
WMKA => Alor Setar Алор-Сетар
WMKB => Butterworth Баттерворт
WMKC => Kota Bharu Кота-Бару
WMKD => Kuantan Куантан
WMKE => Kerteh Кертех
WMKI => Ipoh Ипох
WMKJ => Johor Bahru Джохор-Бару
WMKK => Kuala Lumpur Куала-Лумпур
WMKL => Langkawi Лангкави
WMKM => Malacca Малакка
WMKN => Kuala Terengganu Куала-Теренгану
WMKP => Penang Пенанг
WMPA => Pangkor 
WMSA => Kuala Lumpur Куала-Лумпур
WPAT => Atauro Атауро
WPDB => Suai Суаи
WPDH => Dili Дили
WPDL => Dili Дили
WPEC => Baucau Баукау
WPMN => Maliana Малиана
WPOC => Ocussi Окусси
WPVQ => Viqueque Викеке
WRBK => Kotabaru Котабару
WRKB => Bajawa Баджава
WRKL => Larantuka Ларантука
WRKR => Roti Роти
WRKS => Sawu Саву
WRLA => Sanggata Санггата
WRLB => Long Bawan 
WRLC => Bontang Бонтанг
WRLH => Tanah Grogot Танах-Гродот
WRLP => Long Apung Лонг-Апунг
WRLY => Senipah Сенипах
WRSC => Cepu Чепу
WRST => Sumenep Суменеп
WRTA => Ayawasi Аяваси
WRTA => Amityville 
WSAC => Raspberry Strait 
WSAP => Singapore Сингапур
WSSL => Singapore Сингапур
WSSS => Singapore Сингапур
YABA => Albany Олбани
YABI => Abingdon Абингдон
YADS => Alton Downs 
YAGD => Augustus Downs 
YALA => Marla 
YALX => Alexandria Александрия
YAMC => Aramac 
YAMK => Andamooka 
YAMM => Ammaroo 
YAMT => Amata 
YANL => Anthony Lagoon 
YAPH => Alpha 
YARA => Ararat 
YARG => Argyle 
YARM => Armidale Армидаль
YARY => Arrabury 
YAUR => Aurukun Mission 
YAUS => Austral Downs 
YAUV => Auvergne Овернь
YAYE => Ayers Rock Айерс Рок
YAYR => Ayr Эйр
YBAM => Bamaga, Queensland 
YBAR => Barcaldine 
YBAS => Alice Springs Элис Спрингз
YBAU => Badu Island 
YBAW => Barkly Downs 
YBBN => Brisbane Брисбан
YBCG => Coolangatta/Gold Coast 
YBCK => Blackall 
YBCS => Cairns Кернс
YBCV => Charleville 
YBDF => Bedford Downs 
YBDV => Birdsville, Queensland Бирдсвилл
YBEO => Betoota 
YBGB => Beagle Bay 
YBGO => Balgo Hills 
YBHI => Broken Hill 
YBHM => Hamilton Island Хамилтон Айленд
YBIE => Bedourie 
YBIL => Billiluna 
YBIZ => Bizant 
YBKE => Bourke 
YBKT => Burketown 
YBLA => Benalla 
YBLC => Balcanoona 
YBLL => Bollon 
YBMA => Mount Isa 
YBMC => Sunshine Coast 
YBMD => Bloomfield 
YBMK => Mackay Маккей
YBNA => Ballina Баллина
YBNS => Bairnsdale 
YBOI => Boigu Island 
YBOK => Oakey 
YBOU => Boulia 
YBPI => Brampton Island Бремптон Айленд
YBPN => Proserpine 
YBRK => Rockhampton Рокхэмптон
YBRL => Borroloola 
YBRM => Broome, Western Australia Брум
YBRN => Balranald 
YBRU => Brunette Downs 
YBRW => Brewarrina 
YBTD => Brighton Downs 
YBTH => Bathurst Батерст
YBTI => Bathurst Island 
YBTL => Townsville Таунсвилл
YBTR => Blackwater 
YBTV => Batavia Downs 
YBUD => Bundaberg Бандаберг
YBUN => Bunbury Банбери
YBWM => Bulimba 
YBWN => Bowen 
YBWP => Boulder 
YBWP => Weipa 
YBWR => Bolwarra 
YBWX => Barrow Island 
YBYS => Beverley Springs 
YCAC => Cattle Creek Кэттл-Крик
YCAG => Caiguna 
YCAH => Coolah 
YCAR => Carnarvon 
YCAS => Phoenix Феникс
YCBA => Cobar 
YCBB => Coonabarabran 
YCBE => Canobie 
YCBN => Cape Barren Island 
YCBP => Coober Pedy Кубер Педи
YCBR => Collarenebri 
YCCA => Chinchilla Шиншилла
YCCT => Coconut Island 
YCCY => Cloncurry 
YCDO => Condobolin 
YCDR => Caloundra Калундра
YCDU => Ceduna 
YCEE => Cleve 
YCFH => Clifton Hills 
YCFL => Cape Flattery Кейп-Флеттери
YCGO => Chillagoe 
YCHT => Charters Towers 
YCKI => Croker Island 
YCKN => Cooktown Куктаун
YCMT => Clermont 
YCMU => Cunnamulla 
YCMW => Camooweal 
YCNF => Nifty 
YCNK => Cessnock 
YCNM => Coonamble 
YCOD => Cordillo Downs 
YCOE => Coen 
YCOI => Collie 
YCOM => Cooma Коома
YCOO => Cooinda Куинда
YCOR => Corowa 
YCPN => Carpentaria Downs 
YCRG => Corryong 
YCRK => Christmas Creek 
YCRY => Croydon 
YCSV => Collinsville 
YCTM => Cootamundra 
YCUA => Cudal 
YCUE => Cube Cove 
YCUE => Cue 
YCWI => Cowarie 
YCWL => Cowell 
YCWR => Cowra 
YCWY => Coolawanyah 
YDAY => Dalby 
YDBI => Dirranbandi 
YDBR => Dunbar 
YDBY => Derby 
YDDF => Drumduff 
YDIX => Dixie 
YDKI => Dunk Island Данк Айленд
YDLK => Dulkaninna 
YDLQ => Deniliquin 
YDLT => Delta Downs 
YDLV => Delissaville 
YDLW => Daly Waters 
YDMG => Doomadgee 
YDNI => Darnley Island 
YDOR => Dorunda Station 
YDPD => Davenport Downs 
YDPO => Devonport Девонпорт
YDRA => Dongara 
YDRH => Durham Downs 
YDRI => Durrie 
YDVR => Docker River 
YDYS => Dysart 
YECH => Echuca Эчука
YECL => Eucla 
YEDA => Etadunna 
YEEB => Eneabba West 
YEIN => Einasleigh 
YELD => Elcho Island 
YELK => Elkedra 
YEML => Emerald 
YERL => Erldunda 
YERN => Ernabella 
YESP => Esperance 
YEVA => Eva Downs 
YEVD => Evans Head 
YEXM => Exmouth Gulf 
YFBS => Forbes 
YFIL => Finley 
YFLI => Flinders Island 
YFNE => Finke 
YFNE => Fin Creek 
YFRT => Forrest 
YFST => Forster 
YFTZ => Fitzroy Crossing 
YGAM => Gamboola 
YGAY => Gayndah 
YGBI => Goulburn Island 
YGDH => Gunnedah 
YGDI => Goondiwindi 
YGDN => Gordon Downs 
YGDS => Gregory Downs 
YGDW => Granites 
YGEL => Geraldton 
YGFN => Grafton 
YGIB => Gibb River 
YGKL => Great Keppel Island 
YGLA => Gladstone Гледстоун
YGLB => Goulburn Гоулбурн
YGLE => Glengyle 
YGLG => Geelong Гелонг
YGLI => Glen Innes 
YGLO => Glenormiston Гленормистон
YGNV => Greenvale 
YGPT => Garden Point 
YGSC => Gascoyne Junction 
YGTE => Groote Eylandt 
YGTH => Griffith 
YGTN => Georgetown 
YGTO => George Town 
YGYM => Gympie 
YHAW => Hawker 
YHAY => Hay 
YHBA => Hervey Bay Херви Бей
YHBR => Humbert River Хамберт-Ривер
YHBY => Henbury 
YHDY => Headingly 
YHHY => Highbury Хайбери
YHID => Horn Island Хорн-Айленд
YHID => Thursday Island 
YHIL => Hillside 
YHLC => Halls Creek Холлз Крик
YHMB => Hermannsburg 
YHML => Hamilton Гамильтон
YHOO => Hooker Creek 
YHOT => Mount Hotham 
YHPN => Hopetoun 
YHSM => Horsham 
YHTL => Heathlands 
YHUG => Hughenden 
YIDK => Indulkana 
YIFL => Innisfail 
YIFY => Iffley 
YIGM => Ingham 
YIKM => Inkerman 
YINJ => Injune 
YINN => Innamincka 
YINW => Inverway 
YISF => Isisford 
YIVL => Inverell 
YJAB => Jabiru Джабиру
YJDA => Jundah 
YJLC => Julia Creek 
YJNB => Jurien Bay 
YKAL => Kalumburu 
YKBL => Kambalda 
YKBR => Kalbarri 
YKBY => Streaky Bay 
YKCA => Kings Canyon Кингз Каньон
YKCS => Kings Creek Station Кингз Крик Стэйшн
YKER => Kerang 
YKII => King Island, Tasmania Кинг-Айленд
YKKG => Kalkurung Калкурунг
YKLA => Koolatah 
YKLB => Koolburra 
YKMB => Karumba 
YKML => Kamileroi 
YKMP => Kempsey 
YKNG => Katanning 
YKOW => Kowanyama 
YKPR => Kalpowar 
YKRY => Kingaroy, Queensland Кингарой
YKSC => Kingscote 
YKUB => Kubin Island Кубин-Айленд
YLAH => Lawn Hill 
YLEC => Leigh Creek 
YLEO => Leonora 
YLEV => Lake Evella 
YLFD => Lakefield 
YLHI => Lord Howe Island 
YLHR => Lockhart River 
YLHS => Lyndhurst Линдхерст
YLIN => Lindeman Island 
YLIS => Lismore 
YLKN => Lake Nash 
YLND => Lakeland Downs Лейклэнд-Даунз
YLOK => Lock 
YLOR => Lorraine Лотарингия
YLOV => Lotusvale 
YLRA => Laura 
YLRD => Lightning Ridge 
YLRE => Longreach 
YLRS => Laura Station 
YLST => Leinster 
YLTN => Laverton 
YLTV => Latrobe Латроуб
YLTV => Traralgon 
YLZI => Lizard Island Лизард Айленд
YMAA => Mabuiag Island 
YMAV => Geelong Гелонг
YMAY => Albury Элбери
YMBA => Mareeba 
YMBL => Marble Bar 
YMCO => Mallacoota 
YMCR => Manners Creek 
YMCT => Millicent 
YMDG => Mudgee Муджи
YMDI => Mandora 
YMDS => Macdonald Downs 
YMEK => Meekatharra 
YMEN => Melbourne Мельбурн
YMER => Merimbula Меримбула
YMEU => Merluna 
YMGB => Milingimbi 
YMGD => Maningrida 
YMGN => Mount Gunson 
YMGT => Margaret River Station 
YMGV => Musgrave 
YMHB => Hobart Хобарт
YMHO => Mount House 
YMHU => Mcarthur River 
YMIA => Mildura Мильдура
YMIN => Minlaton 
YMIP => Mitchell Plateau Митчелл-Плато
YMIR => Miranda Downs 
YMIT => Mitchell Митчелл
YMJM => Manjimup 
YMLT => Launceston Лончестон
YMMB => Mentone 
YMML => Melbourne Мельбурн
YMMU => Middlemount 
YMND => Maitland Мейтленд
YMNE => Mount Keith 
YMNK => Monkira 
YMNS => Mount Swan 
YMNY => Morney 
YMOG => Mount Magnet 
YMOO => Mooraberree 
YMOR => Moree Мори
YMOT => Moreton 
YMPA => Minnipa 
YMQA => Marqua 
YMRB => Moranbah 
YMRE => Marree 
YMRW => Morawa 
YMRY => Moruya 
YMSF => Mt Sandford 
YMTA => Mittiebah 
YMTB => Muttaburra 
YMTG => Mount Gambier 
YMTI => Mornington 
YMTO => Monto 
YMUC => Muccan 
YMUG => Mungeranie 
YMUI => Murray Island 
YMUK => Mulka 
YMUP => Mulga Park 
YMVG => Mt Cavenagh 
YMWA => Mullewa 
YMWT => Moolawatana 
YMWX => Marion Downs 
YMYB => Maryborough 
YMYR => Myroodah Майруда
YMYT => Merty 
YNAP => Nappa Merry 
YNAR => Narrandera 
YNBR => Narrabri 
YNGU => Ngukurr 
YNHS => Nambucca Heads Намбука Хэдс
YNIC => Nicholson 
YNKA => Noonkanbah 
YNPB => Napperby 
YNRC => Naracoorte 
YNRG => Narrogin 
YNSH => Noosaville 
YNSM => Norseman 
YNTN => Normanton 
YNUB => Nullarbor 
YNUL => Nullagine 
YNUM => Numbulwar 
YNUT => Nutwood Downs 
YNWN => Newman Ньюмен
YNYN => Nyngan 
YOEN => Oenpelli 
YOLA => Colac 
YOLD => Olympic Dam 
YOLW => Onslow 
YOOD => Oodnadatta 
YOOM => Moomba Мумба
YORB => Orbost 
YORG => Orange Орандж
YORV => Ord River 
YOUY => Ouyen 
YPAD => Adelaide Аделаида
YPAG => Port Augusta Порт Огаста
YPAM => Palm Island Пам-Айленд
YPBO => Paraburdoo 
YPCC => Cocos Islands 
YPDI => Pandie Pandie 
YPDN => Darwin Дарвин
YPDO => Pardoo 
YPEC => Newcastle Ньюкасл
YPGV => Danger Bay 
YPGV => Douglas 
YPGV => Togiak Fish 
YPGV => Gove 
YPGV => Grandview 
YPIR => Port Pirie 
YPJT => Perth Перт
YPKA => Karratha Каррата
YPKG => Kalgoorlie Калгурли
YPKS => Parkes Паркес
YPKT => Port Keats 
YPKU => Kununurra Кунунурра
YPLC => Port Lincoln 
YPLM => Learmonth 
YPMP => Edward River 
YPMQ => Port Macquarie Порт Макгуайр
YPNG => Penong 
YPOD => Portland Портланд
YPPD => Port Hedland 
YPPH => Perth Перт
YPSH => Penneshaw 
YPTN => Katherine Кэтрин
YPWR => Woomera 
YPXM => Christmas Island 
YQDI => Quirindi 
YQLP => Quilpie 
YQNS => Queenstown Куинстаун
YRBR => Robinson River Робинзон-Ривер
YREN => Renmark 
YRMD => Richmond Ричмонд
YRNG => Ramingining 
YROB => Robinhood 
YROE => Roebourne 
YROI => Robinvale 
YROM => Roma 
YRRB => Roper Bar Ропер-Бэй
YRSB => Roseberth 
YRTI => Rottnest Island остров Роттнест
YRTP => Rutland Plains Рутланд-Плейнз
YRYH => Roy Hill Рой-Хилл
YSAN => Sandstone 
YSBK => Sydney Сидней
YSCB => Canberra Канберра
YSCH => Coffs Harbour Коффс Харбор
YSCH => Kastamonu Кастамону
YSCN => Camden 
YSCO => Scone 
YSCR => Southern Cross 
YSDU => Dabaa City 
YSDU => Dubbo Дуббо
YSGE => St George Сент Джордж
YSGT => Singleton 
YSGW => South Galway Сауз-Галвей
YSHG => Shay Gap 
YSHK => Monkey Mia Монки Миа
YSHR => Shute Harbour 
YSHT => Shepparton Шеппартон
YSII => Saibai Island 
YSMI => Smithton 
YSMP => Smith Point 
YSMR => Strathmore 
YSNB => Snake Bay 
YSNF => Norfolk Island Норфолк Айленд
YSNW => Nowra 
YSPE => Stanthorpe 
YSPK => Spring Creek 
YSPT => Southport 
YSPV => Springvale 
YSRN => Strahan Страхан
YSSY => Sydney Сидней
YSTH => St Helens Сент Хеленс
YSTW => Tamworth Тамворт
YSWG => Wagga Wagga Вагга-Вагга
YSWH => Swan Hill Суон Хилл
YSWL => Stawell 
YTAA => Tara 
YTAB => Tableland Тейблленд
YTAM => Taroom Тарум
YTAR => Tarcoola Таркула
YTBR => Timber Creek Тимбер-Крик
YTDR => Theodore Теодоре
YTEF => Telfer 
YTEM => Temora 
YTGA => Tangalooma Тангалума
YTGM => Thargomindah 
YTHY => Thylungra 
YTIB => Tibooburra 
YTKY => Turkey Creek 
YTMU => Tumut 
YTMY => Tobermorey 
YTNG => Thangool 
YTNK => Tennant Creek Теннант Крик
YTOC => Tocumwal 
YTRE => Taree Тари
YTWB => Toowoomba 
YUDA => Undarra Ундарра
YUNY => Cluny 
YUSL => Useless Loop 
YVRD => Victoria River Downs 
YVRS => Vanrook 
YWAC => Sarichef 
YWAL => Wallal Валлал
YWAV => Wave Hill 
YWBL => Warrnambool Варранамбул
YWBS => Sue Island 
YWCA => Wilcannia 
YWCH => Walcha Валха
YWCK => Warwick 
YWDA => Windarra 
YWDH => Windorah 
YWDL => Wondoola Вондула
YWGT => Wangaratta 
YWHA => Whyalla Вайалла
YWHI => Airlie Beach Эйрли Бич
YWIT => Wittenoom 
YWKB => Warracknabeal 
YWLG => Walgett 
YWLM => Newcastle Ньюкасл
YWLU => Wiluna 
YWMP => Wrotham Park 
YWND => Wondai Вондай
YWOL => Wollongong Воллонгонг
YWOR => Wollogorang Воллогорэнг
YWSL => Sale Сейл
YWTL => Waterloo Ватерло
YWTN => Winton 
YWUD => Wudinna 
YWWA => Wee Waa 
YWWG => Warrawagine 
YWWI => Woodie Woodie 
YWWL => West Wyalong 
YWYM => Wyndham 
YWYY => Burnie 
YYAL => Yalgoo 
YYKI => Yorke Island 
YYLR => Yeelirrie 
YYMI => Yam Island 
YYND => Yuendumu 
YYNG => Young 
YYOR => Yorketown 
YYPQ => Phu Quoc Пху-Квок
YYTA => Yalata Mission 
ZBAA => Beijing Пекин
ZBCD => Chelinda 
ZBCF => Chifeng Чифен
ZBCZ => Changzhi Чанжи
ZBDS => Dongsheng 
ZBDT => Datong Датонг
ZBHH => Hohhot Хоххот
ZBLA => Hailar Хайлар
ZBNY => Beijing Пекин
ZBOW => Baotou Баотоу
ZBSH => Qinhuangdao Циньхуандао
ZBSJ => Huelva Гуелва
ZBSJ => Shijiazhuang Шицзяжун
ZBTJ => Tianjin Тяньцзинь
ZBTL => Tongliao Тонглян
ZBUH => Wu Hai 
ZBUL => Ulanhot Уланьхот
ZBXH => Xilinhot Хайлиньхот
ZBXT => Xingtai Хайнтай
ZBYC => Yun Cheng 
ZBYN => Taiyuan Тайвань
ZGBH => Beihai Бейхай
ZGCD => Changde Чандэ
ZGCS => Changsha Чанша
ZGDY => Dayong Дэань
ZGFS => Fuoshan Фушань
ZGGG => Guangzhou Гуанчжоу
ZGHA => Changsha Чанша
ZGHY => Hengyang Хеньян
ZGHZ => Huizhou Хуэйчжоу
ZGKL => Guilin Гуйлинь
ZGMX => Meixian Мейсян
ZGNN => Nanning Наньнин
ZGNN => Hammersmith 
ZGOW => Shantou Шаньтоу
ZGSD => Zhuhai Чжухай
ZGSZ => Shenzhen Шэньчжэнь
ZGWZ => Wuzhou Вучжоу
ZGXN => Xingning Хайньнин
ZGZH => Liuzhou Лучжоу
ZGZJ => Zhanjiang Чжаньчзян
ZHAY => Anyang Аньян
ZHCC => Zhengzhou Чженчжоу
ZHES => Enshi Энши
ZHGH => Guanghua 
ZHHH => Wuhan Вухан
ZHLY => Luoyang Люян
ZHNY => Nanyang Наньян
ZHSS => Shashi Шаши
ZHXF => Xiangfan Сянфань
ZHYC => Yichang Фучэн
ZJHK => Haikou Хайкоу
ZJSY => Sanya Санья
ZJYX => Dabo 
ZJYX => Doha Доха
ZJYX => Vienna Вена
ZJYX => Nykoping Никопинг
ZJYX => Herrljunga 
ZJYX => Rail (Generic) 
ZJYX => Rail (Generic) 
ZKPY => Pyongyang Пхеньян
ZLAK => Ankang Анькан
ZLAN => Lanzhou Ланчжоу
ZLDH => Dunhuang Дунхуань
ZLGM => Golmud Голмуд
ZLHZ => Hanzhong Ханьчжун
ZLIC => Yinchuan Фучуан
ZLJN => Jining Цзинин
ZLJQ => Jiuquan 
ZLJQ => Jiayuguan Цзяюйгуань
ZLLD => Lanzhou Ланчжоу
ZLLL => Lanzhou Ланчжоу
ZLQY => Qingyang Куаньян
ZLSN => Xi An 
ZLSN => Mangla 
ZLXN => Kagvik Creek 
ZLXN => Xining Хайнин
ZLXY => Liege Льеж
ZLXY => Xi An 
ZLXY => Nasiriyah 
ZLXY => Falkenberg 
ZLXY => Kristinehamn 
ZLYL => Yulin Фулин
ZMAH => Arvaikheer 
ZMAT => Altai Алтай
ZMBH => Bayankhongor 
ZMBN => Bulgan 
ZMBU => Baruun-Urt 
ZMCD => Choibalsan 
ZMDZ => Dalanzadgad 
ZMED => Erdenet 
ZMHH => Kharkhorin 
ZMHU => Khujirt 
ZMKD => Khovd 
ZMMG => Mandalgobi 
ZMMN => Moron 
ZMTG => Tsetserleg 
ZMUB => Uganik 
ZMUB => Ulaanbaatar 
ZMUB => Queen 
ZMUG => Ulaangom 
ZMUH => Underkhaan 
ZMUH => Umnak Island 
ZPBS => Baoshan Баошань
ZPDL => Dali City 
ZPDQ => Diqing 
ZPJH => Jinghong Цзиньхонг
ZPLC => Lincang 
ZPLJ => Lijiang City город Лицзян
ZPMS => Luxi Луси
ZPMS => Linxi 
ZPPP => Kunming Кунминг
ZPPP => Waterkloof 
ZPSM => Simao Симан
ZPZT => Zhaotong Жаньтон
ZSAM => Dugong 
ZSAM => Flaxman Island 
ZSAM => Gachsaran 
ZSAM => Xiamen Сямэнь
ZSAQ => Anqing Аньцин
ZSBB => Bengbu Бенгбу
ZSCG => Changzhou Чангзу
ZSCN => Nanchang Наньчан
ZSDY => Dongying 
ZSFY => Fuyang Фуан
ZSFZ => Fuzhou Фучжоу
ZSGZ => Ganzhou Ганьчжоу
ZSHC => Hangzhou Ханчжоу
ZSHC => St Marys 
ZSJD => Jingdezhen Цзиньдэчжэнь
ZSJJ => Jiujiang Цзюцзянь
ZSJN => Jinan Цзинань
ZSJU => Juzhou 
ZSLG => Lianyungang Лианьюнан
ZSLO => Longyan 
ZSLQ => Huangyan Хуанань
ZSLS => Lushan 
ZSLY => Linyi 
ZSNB => Ningbo Нинбо
ZSNJ => Nanking/nanjing 
ZSNT => Nantong Наньтун
ZSOF => Hefei Хефей
ZSPD => Shanghai Шанхай
ZSQD => Qingdao Куаньдян
ZSQZ => Jinjiang Цзиньян
ZSRG => Rugao Руган
ZSSS => Shanghai Шанхай
ZSSZ => Santa Cruz Do Sul 
ZSSZ => Suzhou Сучжоу
ZSTX => Tunxi Тунси
ZSWF => Weifang Вэйфан
ZSWH => Weihai Вейхай
ZSWU => Wuhu Вуху
ZSWX => Wuxi Вуси
ZSWY => Wuyishan Вуйшань
ZSWZ => Wenzhou Венчжоу
ZSXZ => Xuzhou Хучжоу
ZSYN => Yancheng Яньчэн
ZSYT => Yantai Янтай
ZSYW => Yiwu Иву
ZSZS => Zhoushan Чжушань
ZUBD => Bangda 
ZUCK => Chongqing Чонсинь
ZUDX => Daxian Дэцзян
ZUDZ => Dazu Дазу
ZUGH => Guanghan Гуанчжань
ZUGU => Guang Yuan 
ZUGY => Guiyang Гуйянг
ZUJZ => Jeju 
ZUJZ => Song Pan 
ZULP => Liangping 
ZULS => Gonggar 
ZULZ => Luzhou Лужчоу
ZUMY => Mian Yang 
ZUNC => Nanchong Наньчон
ZUNP => Liping City 
ZUTR => Tongren 
ZUUU => Chengdu Ченгду
ZUUU => Sesriem Сезрим
ZUWX => Wanxian 
ZUXC => Xichang Хайчэн
ZUYB => Yibin Ибин
ZUZH => Pan Zhi Hua 
ZUZY => Zunyi Цунии
ZWAK => Aksu Аксу
ZWAT => Altay Алтай
ZWCM => Qiemo Куэмо
ZWFY => Fuyun Фуюнь
ZWHM => Hami Хами
ZWKC => Kuqa Куга
ZWKL => Korla Корла
ZWKM => Karamay Карамай
ZWSH => Kashi Каши
ZWSS => Shanshan Шаньшань
ZWTC => Tacheng 
ZWTN => Hotan Хотан
ZWWW => Puertollano 
ZWWW => Urumqi Урумги
ZWYN => Yining Иньин
ZYAS => Anshan Аньшань
ZYCC => Changchun Чаньчунь
ZYCH => Changhai 
ZYCY => Chaoyang Чаоян
ZYDD => Dandong Даньдон
ZYHB => Harbin Харбин
ZYHE => Heihe Хейхе
ZYJL => Jilin Цзилинь
ZYJM => Jiamusi Джаймуси (Китай)
ZYJZ => Jinzhou Цзиньчжоу
ZYMD => Mudanjiang Муданьцзян
ZYQQ => Qiqihar Цицихар
ZYTL => Dalian Далиан
ZYTN => Tonghua Тонхва
ZYTX => Shenyang Шеньян
ZYXC => Xingcheng Хайньчен
ZYYJ => Yanji Яньцзи
ZYYL => Yilan Фулан